Model_ID,Model,Inference_Memory_Usage,Peak_Memory_During_Inference,Predictor_Size,Learner_Size,Models_Size,Total_Size
XT_0,ExtraTrees_c1,5.15625,176.79296875,387,7710,5478445,5486542
XT_1,ExtraTrees_r1,0.625,149.15625,456,7710,800863,809029
XT_2,ExtraTrees_r2,1.875,181.8515625,454,7710,1694713,1702877
XT_3,ExtraTrees_r3,4.375,183.3046875,454,7710,2318145,2326309
XT_4,ExtraTrees_r4,0.15625,172.0625,456,7710,434363,442529
XT_5,ExtraTrees_r5,6.25,154.578125,454,7710,3573018,3581182
XT_6,ExtraTrees_r6,0.78125,198.55859375,454,7710,662231,670395
XT_7,ExtraTrees_r7,0.625,179.59375,454,7710,151586,159750
XT_8,ExtraTrees_r8,1.5625,150.859375,454,7710,1694713,1702877
XT_9,ExtraTrees_r9,0.46875,148.97265625,454,7710,662231,670395
XT_10,ExtraTrees_r10,0.3125,176.12890625,455,7710,151590,159755
XT_11,ExtraTrees_r11,1.5625,198.27734375,455,7710,1694717,1702882
XT_12,ExtraTrees_r12,0.46875,172.6015625,457,7710,249969,258136
XT_13,ExtraTrees_r13,5.3125,185.18359375,455,7710,5478545,5486710
XT_14,ExtraTrees_r14,0.3125,177.29296875,457,7722,244544,252723
XT_15,ExtraTrees_r15,2.34375,195.4375,457,7710,2427323,2435490
XT_16,ExtraTrees_r16,3.59375,155.09765625,457,7710,3515298,3523465
XT_17,ExtraTrees_r17,0.625,182.25,457,7710,800867,809034
XT_18,ExtraTrees_r18,3.4375,191.6796875,455,7710,3573022,3581187
XT_19,ExtraTrees_r19,2.65625,185.79296875,457,7710,2979386,2987553
XT_20,ExtraTrees_r20,1.5625,192.5390625,455,7710,1694717,1702882
XT_21,ExtraTrees_r21,2.1875,152.4921875,457,7710,2427323,2435490
XT_22,ExtraTrees_r22,1.25,169.16796875,457,7710,1556975,1565142
XT_23,ExtraTrees_r23,14.2578125,193.68359375,457,7710,425220,433387
XT_24,ExtraTrees_r24,1.71875,178.21875,457,7710,1564495,1572662
XT_25,ExtraTrees_r25,1.5625,165.79296875,457,7722,1556999,1565178
XT_26,ExtraTrees_r26,1.078125,195.74609375,455,7710,1336592,1344757
XT_27,ExtraTrees_r27,0.3125,182.1953125,457,7710,249969,258136
XT_28,ExtraTrees_r28,1.71875,151.671875,455,7710,1694717,1702882
XT_29,ExtraTrees_r29,0.46875,183.6796875,455,7710,662235,670400
XT_30,ExtraTrees_r30,1.40625,150.66015625,455,7710,1336592,1344757
XT_31,ExtraTrees_r31,1.71875,187.3125,457,7710,1898291,1906458
XT_32,ExtraTrees_r32,7.34375,189.90234375,457,7710,4265468,4273635
XT_33,ExtraTrees_r33,2.1875,175.5546875,455,7710,2318149,2326314
XT_34,ExtraTrees_r34,0.46875,170.2890625,457,7710,249969,258136
XT_35,ExtraTrees_r35,2.03125,166.51953125,457,7710,2427323,2435490
XT_36,ExtraTrees_r36,2.1875,196.26171875,457,7722,1910955,1919134
XT_37,ExtraTrees_r37,1.71875,174.96875,457,7710,1898291,1906458
XT_38,ExtraTrees_r38,2.34375,153.1484375,457,7710,2374034,2382201
XT_39,ExtraTrees_r39,2.96875,187.62109375,457,7710,3134444,3142611
XT_40,ExtraTrees_r40,0.78125,182.64453125,457,7710,434367,442534
XT_41,ExtraTrees_r41,2.5,174.98046875,457,7710,2427323,2435490
XT_42,ExtraTrees_r42,3.28125,177.3125,457,7722,3772149,3780328
XT_43,ExtraTrees_r43,1.5625,184.7890625,455,7710,1694717,1702882
XT_44,ExtraTrees_r44,0.78125,192.7421875,457,7710,167306,175473
XT_45,ExtraTrees_r45,2.03125,185.4765625,455,7710,2318149,2326314
XT_46,ExtraTrees_r46,2.34375,169.1953125,457,7710,2427323,2435490
XT_47,ExtraTrees_r47,0.625,173.8984375,457,7710,171626,179793
XT_48,ExtraTrees_r48,2.03125,179.71875,457,7710,2427323,2435490
XT_49,ExtraTrees_r49,5.3125,193.828125,455,7710,5478545,5486710
XT_50,ExtraTrees_r50,0.625,149.2734375,457,7710,434367,442534
XT_51,ExtraTrees_r51,0.3125,181.84375,455,7710,151590,159755
XT_52,ExtraTrees_r52,0.46875,178.8359375,455,7710,662235,670400
XT_53,ExtraTrees_r53,0.3125,148.75390625,455,7710,365302,373467
XT_54,ExtraTrees_r54,0.3125,189.140625,457,7710,171626,179793
XT_55,ExtraTrees_r55,0.625,173.7265625,455,7710,365302,373467
XT_56,ExtraTrees_r56,2.1875,152.765625,455,7710,2318149,2326314
XT_57,ExtraTrees_r57,0.625,189.359375,455,7710,365302,373467
XT_58,ExtraTrees_r58,0.15625,148.7421875,455,7710,151590,159755
XT_59,ExtraTrees_r59,1.8671875,192.0234375,455,7710,2318149,2326314
XT_60,ExtraTrees_r60,0.78125,197.71484375,457,7710,425220,433387
XT_61,ExtraTrees_r61,0.625,162.20703125,457,7710,793987,802154
XT_62,ExtraTrees_r62,0.3125,189.87109375,457,7710,171626,179793
XT_63,ExtraTrees_r63,0.46875,195.6796875,457,7710,434367,442534
XT_64,ExtraTrees_r64,0.15625,169.86328125,457,7710,171626,179793
XT_65,ExtraTrees_r65,0.15625,178.57421875,457,7710,244520,252687
XT_66,ExtraTrees_r66,1.40625,178.62109375,457,7710,1556975,1565142
XT_67,ExtraTrees_r67,0.15625,167.30078125,457,7710,249969,258136
XT_68,ExtraTrees_r68,0.625,186.953125,455,7710,217400,225565
XT_69,ExtraTrees_r69,2.34375,177.53125,457,7722,2427347,2435526
XT_70,ExtraTrees_r70,0.46875,164.70703125,457,7710,254455,262622
XT_71,ExtraTrees_r71,1.875,171.64453125,455,7710,2318149,2326314
XT_72,ExtraTrees_r72,0.46875,161.98828125,455,7722,662259,670436
XT_73,ExtraTrees_r73,1.5625,177.93359375,455,7710,1336592,1344757
XT_74,ExtraTrees_r74,0.3125,164.99609375,455,7710,662235,670400
XT_75,ExtraTrees_r75,0.625,184.02734375,455,7710,151590,159755
XT_76,ExtraTrees_r76,1.71875,187.99609375,455,7710,1694717,1702882
XT_77,ExtraTrees_r77,0.3125,191.36328125,455,7710,151590,159755
XT_78,ExtraTrees_r78,3.28125,174.4296875,457,7722,3515322,3523501
XT_79,ExtraTrees_r79,0.46875,178.62890625,455,7710,217400,225565
XT_80,ExtraTrees_r80,2.03125,176.8515625,457,7710,2374034,2382201
XT_81,ExtraTrees_r81,3.125,154.93359375,455,7710,3573022,3581187
XT_82,ExtraTrees_r82,2.1875,184.1484375,457,7710,2374034,2382201
XT_83,ExtraTrees_r83,0.3125,149.66015625,457,7710,800867,809034
XT_84,ExtraTrees_r84,0.46875,189.4609375,457,7710,768067,776234
XT_85,ExtraTrees_r85,2.8125,195.21484375,457,7710,3134444,3142611
XT_86,ExtraTrees_r86,1.71875,151.15234375,457,7710,1898291,1906458
XT_87,ExtraTrees_r87,0.3125,170.75,455,7710,662235,670400
XT_88,ExtraTrees_r88,2.03125,152.37890625,455,7710,2318149,2326314
XT_89,ExtraTrees_r89,5.9375,178.60546875,455,7710,3573022,3581187
XT_90,ExtraTrees_r90,0.15625,148.59765625,455,7710,365302,373467
XT_91,ExtraTrees_r91,1.0859375,164.10546875,455,7710,1336592,1344757
XT_92,ExtraTrees_r92,1.71875,165.1484375,455,7722,1694741,1702918
XT_93,ExtraTrees_r93,0.46875,164.9609375,457,7710,249969,258136
XT_94,ExtraTrees_r94,0.46875,184.3828125,455,7710,151590,159755
XT_95,ExtraTrees_r95,1.5625,151.46875,457,7710,1524166,1532333
XT_96,ExtraTrees_r96,1.71875,150.9453125,455,7710,1336592,1344757
XT_97,ExtraTrees_r97,0.46875,183.96875,455,7710,365302,373467
XT_98,ExtraTrees_r98,2.1875,152.62109375,457,7710,2374034,2382201
XT_99,ExtraTrees_r99,1.875,183.37890625,457,7710,1906451,1914618
XT_100,ExtraTrees_r100,0.15625,175.65234375,456,7710,662239,670405
XT_101,ExtraTrees_r101,0.46875,188.7734375,456,7710,662239,670405
XT_102,ExtraTrees_r102,0.46875,148.9921875,458,7710,249973,258141
XT_103,ExtraTrees_r103,1.25,197.27734375,458,7710,1564499,1572667
XT_104,ExtraTrees_r104,1.71875,191.5625,456,7710,1694721,1702887
XT_105,ExtraTrees_r105,2.34375,194.09765625,458,7710,2427327,2435495
XT_106,ExtraTrees_r106,0.46875,173.38671875,458,7710,244524,252692
XT_107,ExtraTrees_r107,0.46875,181.15234375,458,7710,254459,262627
XT_108,ExtraTrees_r108,0.625,169.33203125,456,7710,662239,670405
XT_109,ExtraTrees_r109,5.15625,202.578125,456,7710,5478549,5486715
XT_110,ExtraTrees_r110,1.40625,194.08984375,458,7710,1898295,1906463
XT_111,ExtraTrees_r111,0.625,175.6328125,458,7710,409846,418014
XT_112,ExtraTrees_r112,5.46875,193.1875,456,7710,5478549,5486715
XT_113,ExtraTrees_r113,0.15625,175.046875,456,7710,151594,159760
XT_114,ExtraTrees_r114,5.9375,170.07421875,458,7710,3134448,3142616
XT_115,ExtraTrees_r115,2.34375,152.6640625,458,7722,2374062,2382242
XT_116,ExtraTrees_r116,0.625,148.94140625,458,7710,254459,262627
XT_117,ExtraTrees_r117,1.5625,183.34765625,456,7710,1336596,1344762
XT_118,ExtraTrees_r118,0.9375,188.66015625,458,7710,254459,262627
XT_119,ExtraTrees_r119,3.28125,195.7734375,456,7722,3573050,3581228
XT_120,ExtraTrees_r120,3.28125,200.57421875,456,7710,3573026,3581192
XT_121,ExtraTrees_r121,0.46875,148.5546875,458,7710,249973,258141
XT_122,ExtraTrees_r122,25.33984375,186.41796875,458,7710,425224,433392
XT_123,ExtraTrees_r123,0.3125,177.06640625,456,7722,365330,373508
XT_124,ExtraTrees_r124,0.3125,178.52734375,456,7710,151594,159760
XT_125,ExtraTrees_r125,1.5625,181.22265625,458,7710,1564499,1572667
XT_126,ExtraTrees_r126,3.125,190.9140625,456,7710,3573026,3581192
XT_127,ExtraTrees_r127,1.71875,197.98046875,458,7710,1564499,1572667
XT_128,ExtraTrees_r128,0.3125,166.27734375,456,7710,151594,159760
XT_129,ExtraTrees_r129,1.71875,173.26953125,458,7710,1556979,1565147
XT_130,ExtraTrees_r130,1.25,180.6640625,456,7710,1694721,1702887
XT_131,ExtraTrees_r131,2.03125,190.83203125,458,7710,2427327,2435495
XT_132,ExtraTrees_r132,4.6875,168.31640625,456,7710,2318153,2326319
XT_133,ExtraTrees_r133,1.5625,164.03515625,456,7722,1336620,1344798
XT_134,ExtraTrees_r134,4.0625,180.85546875,458,7710,4265472,4273640
XT_135,ExtraTrees_r135,1.40625,187.69921875,456,7710,1336596,1344762
XT_136,ExtraTrees_r136,0.3125,159.54296875,458,7710,171630,179798
XT_137,ExtraTrees_r137,1.5625,174.25,458,7710,1564499,1572667
XT_138,ExtraTrees_r138,0.46875,177.62109375,458,7710,167310,175478
XT_139,ExtraTrees_r139,0.78125,169.79296875,458,7722,794015,802195
XT_140,ExtraTrees_r140,0.15625,187.33203125,456,7710,151594,159760
XT_141,ExtraTrees_r141,1.71875,176.71484375,458,7710,1906455,1914623
XT_142,ExtraTrees_r142,1.5625,188.89453125,458,7710,1906455,1914623
XT_143,ExtraTrees_r143,1.40625,172.52734375,456,7710,1694721,1702887
XT_144,ExtraTrees_r144,3.4375,177.859375,458,7710,3515302,3523470
XT_145,ExtraTrees_r145,0.46875,195.3515625,456,7710,365306,373472
XT_146,ExtraTrees_r146,1.25,191.17578125,456,7710,1694721,1702887
XT_147,ExtraTrees_r147,0.46875,189.82421875,458,7710,244524,252692
XT_148,ExtraTrees_r148,7.8125,172.9921875,456,7710,5478549,5486715
XT_149,ExtraTrees_r149,2.96875,153.8984375,458,7722,3134472,3142652
XT_150,ExtraTrees_r150,2.1875,198.42578125,458,7710,2374038,2382206
XT_151,ExtraTrees_r151,3.28125,201.26953125,456,7710,3573026,3581192
XT_152,ExtraTrees_r152,1.5625,151.27734375,458,7710,1556979,1565147
XT_153,ExtraTrees_r153,1.40625,180.6484375,456,7710,1336596,1344762
XT_154,ExtraTrees_r154,1.5625,170.45703125,456,7722,1336620,1344798
XT_155,ExtraTrees_r155,0.3125,180.2109375,456,7710,217404,225570
XT_156,ExtraTrees_r156,2.23828125,174.4453125,458,7710,244524,252692
XT_157,ExtraTrees_r157,2.34375,195.3359375,458,7710,2488305,2496473
XT_158,ExtraTrees_r158,3.90625,201.40234375,458,7710,4265472,4273640
XT_159,ExtraTrees_r159,0.46875,175.52734375,458,7710,254459,262627
XT_160,ExtraTrees_r160,0.46875,149.71484375,456,7710,662239,670405
XT_161,ExtraTrees_r161,0.46875,180.16796875,458,7710,249973,258141
XT_162,ExtraTrees_r162,2.34375,152.69921875,458,7710,2374038,2382206
XT_163,ExtraTrees_r163,0.3125,168.546875,458,7710,768071,776239
XT_164,ExtraTrees_r164,1.5625,196.36328125,458,7710,1556979,1565147
XT_165,ExtraTrees_r165,2.34375,152.98828125,458,7710,2488305,2496473
XT_166,ExtraTrees_r166,5.0,158.90234375,456,7710,5478549,5486715
XT_167,ExtraTrees_r167,2.1875,152.95703125,456,7710,2318153,2326319
XT_168,ExtraTrees_r168,5.0,200.95703125,456,7710,5478549,5486715
XT_169,ExtraTrees_r169,0.3125,169.2578125,458,7710,167310,175478
XT_170,ExtraTrees_r170,0.625,178.23046875,456,7710,662239,670405
XT_171,ExtraTrees_r171,1.40625,185.16796875,456,7710,1694721,1702887
XT_172,ExtraTrees_r172,1.71875,167.22265625,458,7710,1906455,1914623
XT_173,ExtraTrees_r173,0.3125,164.4375,456,7710,365306,373472
XT_174,ExtraTrees_r174,0.46875,180.63671875,458,7722,434395,442575
XT_175,ExtraTrees_r175,0.78125,149.50390625,458,7710,768071,776239
XT_176,ExtraTrees_r176,1.40625,181.078125,458,7710,1556979,1565147
XT_177,ExtraTrees_r177,2.8125,190.9296875,458,7710,3134448,3142616
XT_178,ExtraTrees_r178,1.875,187.96875,458,7710,1910935,1919103
XT_179,ExtraTrees_r179,0.625,193.10546875,458,7710,768071,776239
XT_180,ExtraTrees_r180,0.15625,189.53515625,456,7710,217404,225570
XT_181,ExtraTrees_r181,0.3125,148.82421875,456,7710,365306,373472
XT_182,ExtraTrees_r182,0.46875,192.06640625,456,7710,662239,670405
XT_183,ExtraTrees_r183,2.03125,184.4140625,458,7710,1910935,1919103
XT_184,ExtraTrees_r184,1.71875,186.78515625,458,7710,1898295,1906463
XT_185,ExtraTrees_r185,1.71875,185.37890625,458,7710,1524170,1532338
XT_186,ExtraTrees_r186,0.625,163.9609375,456,7722,151618,159796
XT_187,ExtraTrees_r187,0.15625,186.65234375,458,7710,171630,179798
XT_188,ExtraTrees_r188,0.15625,148.50390625,458,7710,254459,262627
XT_189,ExtraTrees_r189,2.03125,184.08984375,456,7710,2318153,2326319
XT_190,ExtraTrees_r190,0.46875,182.90234375,456,7710,217404,225570
XT_191,ExtraTrees_r191,2.8046875,197.82421875,458,7710,3134448,3142616
XT_192,ExtraTrees_r192,0.15625,189.68359375,456,7710,365306,373472
XT_193,ExtraTrees_r193,1.40625,151.4140625,456,7710,1694721,1702887
XT_194,ExtraTrees_r194,2.03125,193.3203125,458,7710,2374038,2382206
XT_195,ExtraTrees_r195,3.28125,199.6953125,458,7710,3772129,3780297
XT_196,ExtraTrees_r196,4.21875,171.54296875,458,7710,2374038,2382206
XT_197,ExtraTrees_r197,3.28125,188.79296875,458,7710,3515302,3523470
XT_198,ExtraTrees_r198,1.71875,164.80078125,458,7710,1564499,1572667
XT_199,ExtraTrees_r199,2.03125,152.21875,456,7722,2318177,2326355
XT_200,ExtraTrees_r200,0.46875,148.875,458,7710,249973,258141
XGB_0,XGBoost_c1,0.46875,169.3671875,391,7710,8693,16794
XGB_1,XGBoost_c2,0.15625,170.06640625,417,7710,8722,16849
XGB_2,XGBoost_c3,0.46875,169.0546875,414,7722,8227,16363
XGB_3,XGBoost_c4,0.3125,170.390625,439,7722,8256,16417
XGB_4,XGBoost_r1,0.46875,171.18359375,509,7710,8853,17072
XGB_5,XGBoost_r2,0.3125,175.62890625,509,7710,8853,17072
XGB_6,XGBoost_r3,0.3125,173.41015625,509,7722,8878,17109
XGB_7,XGBoost_r4,0.46875,181.1328125,509,7710,8854,17073
XGB_8,XGBoost_r5,0.3125,169.796875,509,7722,8358,16589
XGB_9,XGBoost_r6,0.3125,177.64453125,509,7710,8854,17073
XGB_10,XGBoost_r7,0.3125,171.55078125,509,7710,8853,17072
XGB_11,XGBoost_r8,0.3125,171.21484375,509,7722,8877,17108
XGB_12,XGBoost_r9,0.3125,181.96875,509,7710,8335,16554
XGB_13,XGBoost_r10,0.3125,170.29296875,510,7710,8857,17077
XGB_14,XGBoost_r11,0.46875,170.328125,510,7722,8881,17113
XGB_15,XGBoost_r12,0.3125,169.36328125,510,7722,8362,16594
XGB_16,XGBoost_r13,0.46875,171.28125,510,7710,8857,17077
XGB_17,XGBoost_r14,0.15625,171.9609375,510,7722,8881,17113
XGB_18,XGBoost_r15,0.3125,175.9453125,510,7710,8857,17077
XGB_19,XGBoost_r16,0.3125,174.953125,510,7710,8857,17077
XGB_20,XGBoost_r17,0.46875,171.21875,510,7722,8881,17113
XGB_21,XGBoost_r18,0.3125,169.40625,510,7710,8857,17077
XGB_22,XGBoost_r19,0.625,171.55859375,510,7722,8881,17113
XGB_23,XGBoost_r20,0.3125,180.06640625,510,7710,8858,17078
XGB_24,XGBoost_r21,0.46875,183.7421875,510,7722,8882,17114
XGB_25,XGBoost_r22,0.3125,170.1484375,510,7710,8857,17077
XGB_26,XGBoost_r23,0.3125,171.55859375,510,7710,8857,17077
XGB_27,XGBoost_r24,0.46875,172.57421875,510,7722,8362,16594
XGB_28,XGBoost_r25,0.3125,180.9296875,510,7710,8339,16559
XGB_29,XGBoost_r26,0.46875,175.17578125,510,7710,8339,16559
XGB_30,XGBoost_r27,0.46875,170.48828125,510,7722,8362,16594
XGB_31,XGBoost_r28,0.3125,176.48046875,510,7710,8339,16559
XGB_32,XGBoost_r29,0.3125,174.51953125,510,7710,8857,17077
XGB_33,XGBoost_r30,0.46875,171.89453125,510,7722,8881,17113
XGB_34,XGBoost_r31,0.3125,170.33203125,510,7710,8857,17077
XGB_35,XGBoost_r32,0.46875,177.9140625,510,7722,8882,17114
XGB_36,XGBoost_r33,0.3125,180.9921875,510,7710,8858,17078
XGB_37,XGBoost_r34,0.3125,175.70703125,510,7710,8858,17078
XGB_38,XGBoost_r35,0.46875,172.28515625,510,7722,8881,17113
XGB_39,XGBoost_r36,0.3125,180.87109375,510,7710,8339,16559
XGB_40,XGBoost_r37,0.625,178.7734375,510,7710,8339,16559
XGB_41,XGBoost_r38,0.46875,172.24609375,510,7710,8857,17077
XGB_42,XGBoost_r39,0.3125,171.96484375,510,7722,8881,17113
XGB_43,XGBoost_r40,0.46875,171.73046875,510,7710,8857,17077
XGB_44,XGBoost_r41,0.3125,169.84765625,510,7722,8881,17113
XGB_45,XGBoost_r42,0.3125,176.3515625,510,7710,8858,17078
XGB_46,XGBoost_r43,0.46875,173.95703125,510,7722,8881,17113
XGB_47,XGBoost_r44,0.46875,169.73046875,510,7710,8338,16558
XGB_48,XGBoost_r45,0.46875,170.04296875,510,7722,8881,17113
XGB_49,XGBoost_r46,0.15625,174.05859375,510,7710,8339,16559
XGB_50,XGBoost_r47,0.3125,171.33984375,510,7722,8881,17113
XGB_51,XGBoost_r48,0.3125,177.61328125,510,7710,8858,17078
XGB_52,XGBoost_r49,0.3125,181.58203125,510,7710,8858,17078
XGB_53,XGBoost_r50,0.3125,174.61328125,510,7710,8858,17078
XGB_54,XGBoost_r51,0.3125,169.87109375,510,7722,8362,16594
XGB_55,XGBoost_r52,0.46875,170.68359375,510,7710,8338,16558
XGB_56,XGBoost_r53,0.46875,174.53515625,510,7722,8362,16594
XGB_57,XGBoost_r54,0.3125,171.203125,510,7710,8857,17077
XGB_58,XGBoost_r55,0.3125,170.640625,510,7722,8362,16594
XGB_59,XGBoost_r56,0.625,171.7734375,510,7710,8857,17077
XGB_60,XGBoost_r57,0.3125,178.296875,510,7710,8339,16559
XGB_61,XGBoost_r58,0.46875,170.0859375,510,7722,8362,16594
XGB_62,XGBoost_r59,0.3125,181.40234375,510,7710,8339,16559
XGB_63,XGBoost_r60,0.46875,180.625,510,7710,8858,17078
XGB_64,XGBoost_r61,0.46875,172.01171875,510,7710,8857,17077
XGB_65,XGBoost_r62,0.3125,180.0859375,510,7722,8363,16595
XGB_66,XGBoost_r63,0.3125,171.359375,510,7710,8857,17077
XGB_67,XGBoost_r64,0.3125,169.890625,510,7722,8362,16594
XGB_68,XGBoost_r65,0.3125,175.1953125,510,7710,8857,17077
XGB_69,XGBoost_r66,0.46875,173.7421875,510,7710,8857,17077
XGB_70,XGBoost_r67,0.3125,171.47265625,510,7722,8881,17113
XGB_71,XGBoost_r68,0.15625,172.296875,510,7710,8339,16559
XGB_72,XGBoost_r69,0.46875,170.921875,510,7722,8881,17113
XGB_73,XGBoost_r70,0.15625,170.44140625,510,7710,8857,17077
XGB_74,XGBoost_r71,0.3125,170.9140625,510,7722,8362,16594
XGB_75,XGBoost_r72,0.3125,170.53125,510,7710,8857,17077
XGB_76,XGBoost_r73,0.46875,184.66796875,510,7722,8363,16595
XGB_77,XGBoost_r74,0.3125,171.984375,510,7710,8857,17077
XGB_78,XGBoost_r75,0.3125,174.33984375,510,7722,8881,17113
XGB_79,XGBoost_r76,0.3125,174.66796875,510,7710,8857,17077
XGB_80,XGBoost_r77,0.3125,171.43359375,510,7722,8881,17113
XGB_81,XGBoost_r78,0.3125,177.05859375,510,7710,8339,16559
XGB_82,XGBoost_r79,0.3125,175.19140625,510,7722,8882,17114
XGB_83,XGBoost_r80,0.3125,169.546875,510,7710,8338,16558
XGB_84,XGBoost_r81,0.15625,173.20703125,510,7722,8881,17113
XGB_85,XGBoost_r82,0.3125,173.3203125,510,7710,8857,17077
XGB_86,XGBoost_r83,0.3125,173.7890625,510,7710,8338,16558
XGB_87,XGBoost_r84,0.3125,171.36328125,510,7722,8881,17113
XGB_88,XGBoost_r85,0.3125,171.19140625,510,7710,8857,17077
XGB_89,XGBoost_r86,0.3125,183.015625,510,7722,8363,16595
XGB_90,XGBoost_r87,0.3125,171.02734375,510,7710,8338,16558
XGB_91,XGBoost_r88,0.46875,173.52734375,510,7722,8881,17113
XGB_92,XGBoost_r89,0.3125,170.99609375,510,7710,8857,17077
XGB_93,XGBoost_r90,0.46875,181.58203125,510,7722,8882,17114
XGB_94,XGBoost_r91,0.3125,171.82421875,510,7710,8338,16558
XGB_95,XGBoost_r92,0.78125,172.07421875,510,7722,8362,16594
XGB_96,XGBoost_r93,0.3125,171.58203125,510,7710,8338,16558
XGB_97,XGBoost_r94,0.3125,171.3203125,510,7710,8857,17077
XGB_98,XGBoost_r95,0.46875,171.07421875,510,7722,8881,17113
XGB_99,XGBoost_r96,0.625,173.80859375,510,7722,8881,17113
XGB_100,XGBoost_r97,0.46875,169.64453125,510,7710,8338,16558
XGB_101,XGBoost_r98,0.46875,174.0,510,7710,8338,16558
XGB_102,XGBoost_r99,0.15625,174.2265625,510,7722,8363,16595
XGB_103,XGBoost_r100,0.3125,173.60546875,511,7710,8861,17082
XGB_104,XGBoost_r101,0.3125,173.11328125,511,7722,8366,16599
XGB_105,XGBoost_r102,0.3125,170.87109375,511,7710,8342,16563
XGB_106,XGBoost_r103,0.46875,173.703125,511,7722,8886,17119
XGB_107,XGBoost_r104,0.3125,169.78125,511,7710,8342,16563
XGB_108,XGBoost_r105,0.625,175.62890625,511,7722,8886,17119
XGB_109,XGBoost_r106,0.46875,174.67578125,511,7710,8343,16564
XGB_110,XGBoost_r107,0.46875,171.26171875,511,7710,8861,17082
XGB_111,XGBoost_r108,0.3125,178.98828125,511,7722,8886,17119
XGB_112,XGBoost_r109,0.3125,171.2109375,511,7710,8342,16563
XGB_113,XGBoost_r110,0.46875,171.59765625,511,7710,8861,17082
XGB_114,XGBoost_r111,0.3125,170.64453125,511,7722,8366,16599
XGB_115,XGBoost_r112,0.3125,170.0859375,511,7710,8342,16563
XGB_116,XGBoost_r113,0.3125,173.76953125,511,7722,8366,16599
XGB_117,XGBoost_r114,0.3125,172.96875,511,7710,8342,16563
XGB_118,XGBoost_r115,0.46875,172.17578125,511,7722,8366,16599
XGB_119,XGBoost_r116,0.3125,177.37890625,511,7710,8862,17083
XGB_120,XGBoost_r117,0.3125,174.12890625,511,7710,8861,17082
XGB_121,XGBoost_r118,0.3125,171.18359375,511,7722,8366,16599
XGB_122,XGBoost_r119,0.46875,171.4453125,511,7710,8342,16563
XGB_123,XGBoost_r120,0.46875,177.16796875,511,7722,8367,16600
XGB_124,XGBoost_r121,0.3125,173.5234375,511,7710,8342,16563
XGB_125,XGBoost_r122,0.46875,170.53515625,511,7710,8342,16563
XGB_126,XGBoost_r123,0.46875,171.3671875,511,7722,8366,16599
XGB_127,XGBoost_r124,0.46875,183.20703125,511,7710,8862,17083
XGB_128,XGBoost_r125,0.3125,170.0390625,511,7710,8861,17082
XGB_129,XGBoost_r126,0.625,183.7421875,511,7722,8886,17119
XGB_130,XGBoost_r127,0.46875,169.89453125,511,7710,8342,16563
XGB_131,XGBoost_r128,0.3125,172.859375,511,7722,8885,17118
XGB_132,XGBoost_r129,0.15625,174.67578125,511,7710,8342,16563
XGB_133,XGBoost_r130,0.3125,185.03515625,511,7710,8862,17083
XGB_134,XGBoost_r131,0.46875,180.12890625,511,7722,8367,16600
XGB_135,XGBoost_r132,0.46875,174.859375,511,7710,8861,17082
XGB_136,XGBoost_r133,0.15625,170.76171875,511,7710,8342,16563
XGB_137,XGBoost_r134,0.625,174.26953125,511,7722,8886,17119
XGB_138,XGBoost_r135,0.3125,174.12109375,511,7710,8861,17082
XGB_139,XGBoost_r136,0.3125,178.33203125,511,7722,8367,16600
XGB_140,XGBoost_r137,0.3125,175.15625,511,7710,8861,17082
XGB_141,XGBoost_r138,0.3125,175.80078125,511,7710,8862,17083
XGB_142,XGBoost_r139,0.3125,172.08203125,511,7710,8342,16563
XGB_143,XGBoost_r140,0.3125,171.2109375,511,7722,8885,17118
XGB_144,XGBoost_r141,0.3125,171.68359375,511,7710,8861,17082
XGB_145,XGBoost_r142,0.3125,169.5078125,511,7722,8366,16599
XGB_146,XGBoost_r143,0.3125,169.77734375,511,7710,8342,16563
XGB_147,XGBoost_r144,0.46875,179.14453125,511,7722,8886,17119
XGB_148,XGBoost_r145,0.46875,170.71875,511,7710,8342,16563
XGB_149,XGBoost_r146,0.3125,173.40234375,511,7710,8342,16563
XGB_150,XGBoost_r147,0.15625,177.40625,511,7722,8885,17118
XGB_151,XGBoost_r148,0.46875,170.0625,511,7710,8861,17082
XGB_152,XGBoost_r149,0.3125,176.0234375,511,7722,8886,17119
XGB_153,XGBoost_r150,0.46875,179.0703125,511,7710,8343,16564
XGB_154,XGBoost_r151,0.3125,183.84375,511,7710,8862,17083
XGB_155,XGBoost_r152,0.3125,169.6171875,511,7710,8342,16563
XGB_156,XGBoost_r153,0.3125,176.01953125,511,7722,8886,17119
XGB_157,XGBoost_r154,0.46875,177.40625,511,7710,8862,17083
XGB_158,XGBoost_r155,0.46875,176.0234375,511,7722,8886,17119
XGB_159,XGBoost_r156,0.46875,171.953125,511,7710,8861,17082
XGB_160,XGBoost_r157,0.3125,174.97265625,511,7710,8343,16564
XGB_161,XGBoost_r158,0.46875,173.03515625,511,7722,8885,17118
XGB_162,XGBoost_r159,0.46875,172.359375,511,7710,8342,16563
XGB_163,XGBoost_r160,0.15625,179.94921875,511,7722,8886,17119
XGB_164,XGBoost_r161,0.3125,172.71875,511,7710,8861,17082
XGB_165,XGBoost_r162,0.15625,172.44140625,511,7710,8342,16563
XGB_166,XGBoost_r163,0.3125,172.3203125,511,7722,8885,17118
XGB_167,XGBoost_r164,0.46875,174.51953125,511,7710,8342,16563
XGB_168,XGBoost_r165,0.625,180.45703125,511,7710,8862,17083
XGB_169,XGBoost_r166,0.3125,176.59765625,511,7722,8886,17119
XGB_170,XGBoost_r167,0.3125,175.75,511,7710,8862,17083
XGB_171,XGBoost_r168,0.3125,178.59765625,511,7710,8343,16564
XGB_172,XGBoost_r169,0.15625,176.19140625,511,7710,8343,16564
XGB_173,XGBoost_r170,0.46875,172.671875,511,7722,8885,17118
XGB_174,XGBoost_r171,0.46875,171.8125,511,7710,8342,16563
XGB_175,XGBoost_r172,0.3125,171.703125,511,7722,8885,17118
XGB_176,XGBoost_r173,0.15625,171.859375,511,7710,8861,17082
XGB_177,XGBoost_r174,0.46875,174.18359375,511,7722,8366,16599
XGB_178,XGBoost_r175,0.3125,169.828125,511,7710,8861,17082
XGB_179,XGBoost_r176,0.15625,174.1015625,511,7722,8885,17118
XGB_180,XGBoost_r177,0.3125,172.046875,511,7710,8861,17082
XGB_181,XGBoost_r178,0.3125,171.0234375,511,7710,8861,17082
XGB_182,XGBoost_r179,0.3125,170.07421875,511,7722,8885,17118
XGB_183,XGBoost_r180,0.3125,170.0078125,511,7710,8861,17082
XGB_184,XGBoost_r181,0.15625,179.4921875,511,7722,8367,16600
XGB_185,XGBoost_r182,0.3125,170.1484375,511,7710,8342,16563
XGB_186,XGBoost_r183,0.46875,170.8203125,511,7722,8366,16599
XGB_187,XGBoost_r184,0.15625,171.05078125,511,7710,8861,17082
XGB_188,XGBoost_r185,0.3125,175.6484375,511,7710,8862,17083
XGB_189,XGBoost_r186,0.3125,181.4296875,511,7722,8367,16600
XGB_190,XGBoost_r187,0.3125,178.40625,511,7710,8862,17083
XGB_191,XGBoost_r188,0.46875,174.171875,511,7710,8342,16563
XGB_192,XGBoost_r189,0.3125,172.2109375,511,7722,8885,17118
XGB_193,XGBoost_r190,0.46875,172.30078125,511,7710,8342,16563
XGB_194,XGBoost_r191,0.78125,170.99609375,511,7710,8861,17082
XGB_195,XGBoost_r192,0.3125,178.3203125,511,7722,8367,16600
XGB_196,XGBoost_r193,0.3125,169.53125,511,7710,8342,16563
XGB_197,XGBoost_r194,0.3125,170.828125,511,7710,8342,16563
XGB_198,XGBoost_r195,0.625,181.0703125,511,7722,8886,17119
XGB_199,XGBoost_r196,0.3125,170.7421875,511,7710,8342,16563
XGB_200,XGBoost_r197,0.3125,170.6328125,511,7722,8885,17118
XGB_201,XGBoost_r198,0.3125,171.94921875,511,7710,8342,16563
XGB_202,XGBoost_r199,0.3125,173.32421875,511,7722,8367,16600
XGB_203,XGBoost_r200,0.3125,179.5234375,511,7710,8862,17083
TABPFN_0,TabPFN_c1,154.57421875,828.8359375,394,7710,103388998,103397102
TABPFN_1,TabPFN_c2,178.19140625,879.95703125,425,7710,103389035,103397170
TABPFN_2,TabPFN_c3,210.66015625,913.83984375,425,7710,103389035,103397170
RF_0,RandomForest_c1,2.8125,172.25,390,7710,2962149,2970249
RF_1,RandomForest_r1,0.46875,149.62890625,456,7710,826317,834483
RF_2,RandomForest_r2,1.40625,182.76953125,454,7710,1760638,1768802
RF_3,RandomForest_r3,1.71875,183.73828125,454,7710,2095723,2103887
RF_4,RandomForest_r4,0.46875,172.9296875,456,7710,453459,461625
RF_5,RandomForest_r5,2.1875,153.33984375,454,7710,2525066,2533230
RF_6,RandomForest_r6,1.41015625,198.36328125,454,7710,837641,845805
RF_7,RandomForest_r7,0.46875,183.6015625,454,7710,172231,180395
RF_8,RandomForest_r8,1.5625,152.0390625,454,7710,1760638,1768802
RF_9,RandomForest_r9,1.09375,150.1796875,454,7710,837641,845805
RF_10,RandomForest_r10,0.15625,181.23828125,455,7710,172235,180400
RF_11,RandomForest_r11,1.5625,198.84765625,455,7710,1760642,1768807
RF_12,RandomForest_r12,0.3125,173.03125,457,7710,265180,273347
RF_13,RandomForest_r13,2.8125,180.03125,455,7710,2962244,2970409
RF_14,RandomForest_r14,0.3125,175.76953125,457,7710,265500,273667
RF_15,RandomForest_r15,1.71875,196.1328125,457,7710,1790447,1798614
RF_16,RandomForest_r16,1.875,152.6171875,457,7710,2230670,2238837
RF_17,RandomForest_r17,0.625,184.6171875,457,7710,826321,834488
RF_18,RandomForest_r18,2.1875,190.01953125,455,7710,2525070,2533235
RF_19,RandomForest_r19,1.71875,182.546875,457,7710,1994954,2003121
RF_20,RandomForest_r20,1.71875,192.59765625,455,7710,1760642,1768807
RF_21,RandomForest_r21,1.5625,152.03125,457,7710,1790447,1798614
RF_22,RandomForest_r22,1.5625,169.53125,457,7710,1377753,1385920
RF_23,RandomForest_r23,14.13671875,189.5859375,457,7710,454124,462291
RF_24,RandomForest_r24,1.5625,178.16015625,457,7722,1353777,1361956
RF_25,RandomForest_r25,2.03125,166.2265625,457,7710,1377753,1385920
RF_26,RandomForest_r26,0.86328125,194.36328125,455,7710,1511175,1519340
RF_27,RandomForest_r27,0.46875,183.21484375,457,7710,265180,273347
RF_28,RandomForest_r28,1.5625,152.171875,455,7710,1760642,1768807
RF_29,RandomForest_r29,0.625,184.71484375,455,7710,837645,845810
RF_30,RandomForest_r30,1.40625,151.54296875,455,7710,1511175,1519340
RF_31,RandomForest_r31,1.40625,188.78515625,457,7710,1626260,1634427
RF_32,RandomForest_r32,2.34375,186.53125,457,7710,2488937,2497104
RF_33,RandomForest_r33,1.875,175.16015625,455,7710,2095727,2103892
RF_34,RandomForest_r34,0.3125,169.6171875,457,7710,265180,273347
RF_35,RandomForest_r35,1.40625,165.66015625,457,7710,1790447,1798614
RF_36,RandomForest_r36,1.40625,196.390625,457,7722,1565964,1574143
RF_37,RandomForest_r37,1.875,175.09765625,457,7710,1626260,1634427
RF_38,RandomForest_r38,1.71875,151.625,457,7722,1735902,1744081
RF_39,RandomForest_r39,1.71875,184.31640625,457,7710,2069843,2078010
RF_40,RandomForest_r40,0.46875,182.984375,457,7710,453463,461630
RF_41,RandomForest_r41,1.40625,173.95703125,457,7710,1790447,1798614
RF_42,RandomForest_r42,5.0,175.59765625,457,7710,2346990,2355157
RF_43,RandomForest_r43,1.875,186.96484375,455,7722,1760666,1768843
RF_44,RandomForest_r44,0.46875,193.125,457,7710,174351,182518
RF_45,RandomForest_r45,1.875,188.44140625,455,7710,2095727,2103892
RF_46,RandomForest_r46,1.5625,168.0625,457,7710,1790447,1798614
RF_47,RandomForest_r47,0.3125,174.03515625,457,7722,174375,182554
RF_48,RandomForest_r48,0.6328125,194.39453125,457,7710,1790447,1798614
RF_49,RandomForest_r49,2.8125,189.19140625,455,7710,2962244,2970409
RF_50,RandomForest_r50,0.625,149.46484375,457,7710,453463,461630
RF_51,RandomForest_r51,0.15625,183.90234375,455,7710,172235,180400
RF_52,RandomForest_r52,0.625,180.0390625,455,7710,837645,845810
RF_53,RandomForest_r53,0.46875,149.63671875,455,7710,452796,460961
RF_54,RandomForest_r54,0.3125,189.828125,457,7710,174351,182518
RF_55,RandomForest_r55,0.3125,174.15234375,455,7710,452796,460961
RF_56,RandomForest_r56,2.03125,153.12109375,455,7722,2095751,2103928
RF_57,RandomForest_r57,0.625,190.265625,455,7710,452796,460961
RF_58,RandomForest_r58,0.46875,149.69921875,455,7710,172235,180400
RF_59,RandomForest_r59,1.71484375,193.2109375,455,7710,2095727,2103892
RF_60,RandomForest_r60,0.625,198.32421875,457,7710,454124,462291
RF_61,RandomForest_r61,0.46875,163.27734375,457,7710,827281,835448
RF_62,RandomForest_r62,0.46875,190.0859375,457,7710,174351,182518
RF_63,RandomForest_r63,0.625,196.64453125,457,7710,453463,461630
RF_64,RandomForest_r64,0.3125,170.078125,457,7710,174351,182518
RF_65,RandomForest_r65,0.3125,179.875,457,7710,265500,273667
RF_66,RandomForest_r66,1.5625,179.19921875,457,7710,1377753,1385920
RF_67,RandomForest_r67,0.3125,166.96875,457,7710,265180,273347
RF_68,RandomForest_r68,0.46875,187.3828125,455,7710,264024,272189
RF_69,RandomForest_r69,2.03125,195.76953125,457,7722,1790471,1798650
RF_70,RandomForest_r70,0.46875,167.79296875,457,7710,264060,272227
RF_71,RandomForest_r71,1.71875,172.296875,455,7710,2095727,2103892
RF_72,RandomForest_r72,0.9375,163.52734375,455,7710,837645,845810
RF_73,RandomForest_r73,1.5625,179.50390625,455,7722,1511199,1519376
RF_74,RandomForest_r74,0.9375,165.859375,455,7710,837645,845810
RF_75,RandomForest_r75,0.15625,185.06640625,455,7710,172235,180400
RF_76,RandomForest_r76,1.71875,190.015625,455,7710,1760642,1768807
RF_77,RandomForest_r77,0.46875,192.8046875,455,7710,172235,180400
RF_78,RandomForest_r78,2.03125,193.79296875,457,7722,2230694,2238873
RF_79,RandomForest_r79,0.15625,179.90625,455,7710,264024,272189
RF_80,RandomForest_r80,1.5625,175.91796875,457,7710,1735878,1744045
RF_81,RandomForest_r81,4.6875,153.2578125,455,7722,2525094,2533271
RF_82,RandomForest_r82,1.25,182.53125,457,7710,1735878,1744045
RF_83,RandomForest_r83,0.78125,150.3203125,457,7710,826321,834488
RF_84,RandomForest_r84,0.30078125,190.765625,457,7710,835921,844088
RF_85,RandomForest_r85,2.03125,193.41796875,457,7710,2069843,2078010
RF_86,RandomForest_r86,1.5625,152.1015625,457,7710,1626260,1634427
RF_87,RandomForest_r87,0.78125,172.328125,455,7710,837645,845810
RF_88,RandomForest_r88,1.71875,152.01171875,455,7710,2095727,2103892
RF_89,RandomForest_r89,2.34375,177.27734375,455,7710,2525070,2533235
RF_90,RandomForest_r90,0.78125,149.8203125,455,7722,452820,460997
RF_91,RandomForest_r91,1.5625,165.640625,455,7710,1511175,1519340
RF_92,RandomForest_r92,1.5625,166.22265625,455,7722,1760666,1768843
RF_93,RandomForest_r93,0.15625,166.12890625,457,7710,265180,273347
RF_94,RandomForest_r94,0.3125,186.828125,455,7710,172235,180400
RF_95,RandomForest_r95,1.40625,151.1484375,457,7710,1425922,1434089
RF_96,RandomForest_r96,1.40625,151.1796875,455,7710,1511175,1519340
RF_97,RandomForest_r97,0.46875,184.9453125,455,7710,452796,460961
RF_98,RandomForest_r98,1.875,152.3984375,457,7710,1735878,1744045
RF_99,RandomForest_r99,1.40625,186.26171875,457,7710,1527851,1536018
RF_100,RandomForest_r100,0.625,176.27734375,456,7722,837673,845851
RF_101,RandomForest_r101,0.9375,190.34375,456,7710,837649,845815
RF_102,RandomForest_r102,0.3125,149.34375,458,7710,265184,273352
RF_103,RandomForest_r103,1.40625,198.1640625,458,7710,1353757,1361925
RF_104,RandomForest_r104,1.71875,191.89453125,456,7710,1760646,1768812
RF_105,RandomForest_r105,1.71875,194.5078125,458,7710,1790451,1798619
RF_106,RandomForest_r106,0.3125,175.23046875,458,7710,265504,273672
RF_107,RandomForest_r107,0.15625,182.99609375,458,7710,264064,272232
RF_108,RandomForest_r108,0.625,170.03125,456,7710,837649,845815
RF_109,RandomForest_r109,2.8125,199.69921875,456,7710,2962248,2970414
RF_110,RandomForest_r110,1.5625,194.7109375,458,7710,1626264,1634432
RF_111,RandomForest_r111,0.625,175.21875,458,7710,454288,462456
RF_112,RandomForest_r112,2.96875,187.19921875,456,7710,2962248,2970414
RF_113,RandomForest_r113,0.15625,183.19921875,456,7722,172263,180441
RF_114,RandomForest_r114,1.71875,168.09375,458,7710,2069847,2078015
RF_115,RandomForest_r115,1.71875,152.0234375,458,7710,1735882,1744050
RF_116,RandomForest_r116,0.3125,149.26953125,458,7710,264064,272232
RF_117,RandomForest_r117,1.5625,184.68359375,456,7710,1511179,1519345
RF_118,RandomForest_r118,0.46875,188.60546875,458,7722,264088,272268
RF_119,RandomForest_r119,1.8671875,194.2265625,456,7710,2525074,2533240
RF_120,RandomForest_r120,2.1875,199.15234375,456,7710,2525074,2533240
RF_121,RandomForest_r121,0.3125,149.2265625,458,7710,265184,273352
RF_122,RandomForest_r122,15.1015625,192.23828125,458,7710,454128,462296
RF_123,RandomForest_r123,0.625,179.7109375,456,7710,452800,460966
RF_124,RandomForest_r124,0.625,180.16796875,456,7710,172239,180405
RF_125,RandomForest_r125,1.875,181.34375,458,7710,1353757,1361925
RF_126,RandomForest_r126,2.1875,189.66796875,456,7710,2525074,2533240
RF_127,RandomForest_r127,1.25,198.3515625,458,7710,1353757,1361925
RF_128,RandomForest_r128,0.46875,172.08984375,456,7710,172239,180405
RF_129,RandomForest_r129,1.5625,174.2734375,458,7710,1377757,1385925
RF_130,RandomForest_r130,1.5625,180.5625,456,7722,1760670,1768848
RF_131,RandomForest_r131,1.5625,190.109375,458,7710,1790451,1798619
RF_132,RandomForest_r132,1.875,168.41796875,456,7710,2095731,2103897
RF_133,RandomForest_r133,1.40625,165.09375,456,7710,1511179,1519345
RF_134,RandomForest_r134,2.1875,177.2578125,458,7710,2488941,2497109
RF_135,RandomForest_r135,1.25,187.640625,456,7710,1511179,1519345
RF_136,RandomForest_r136,0.78125,160.6484375,458,7710,174355,182523
RF_137,RandomForest_r137,1.25,173.0859375,458,7722,1353781,1361961
RF_138,RandomForest_r138,0.78125,179.41796875,458,7710,174355,182523
RF_139,RandomForest_r139,0.625,169.7421875,458,7710,827285,835453
RF_140,RandomForest_r140,0.625,191.6875,456,7710,172239,180405
RF_141,RandomForest_r141,1.25,176.5078125,458,7710,1527855,1536023
RF_142,RandomForest_r142,1.875,191.19140625,458,7710,1527855,1536023
RF_143,RandomForest_r143,1.5625,173.484375,456,7710,1760646,1768812
RF_144,RandomForest_r144,2.03125,175.60546875,458,7710,2230674,2238842
RF_145,RandomForest_r145,0.3125,196.37109375,456,7710,452800,460966
RF_146,RandomForest_r146,1.5625,190.01953125,456,7710,1760646,1768812
RF_147,RandomForest_r147,0.46875,190.22265625,458,7710,265504,273672
RF_148,RandomForest_r148,2.65625,169.203125,456,7722,2962272,2970450
RF_149,RandomForest_r149,1.71875,152.2734375,458,7710,2069847,2078015
RF_150,RandomForest_r150,1.71875,198.375,458,7710,1735882,1744050
RF_151,RandomForest_r151,2.34375,198.66015625,456,7710,2525074,2533240
RF_152,RandomForest_r152,1.40625,151.42578125,458,7710,1377757,1385925
RF_153,RandomForest_r153,1.71875,181.04296875,456,7710,1511179,1519345
RF_154,RandomForest_r154,1.5625,171.19921875,456,7710,1511179,1519345
RF_155,RandomForest_r155,0.3125,183.65625,456,7710,264028,272194
RF_156,RandomForest_r156,4.63671875,178.1171875,458,7710,265504,273672
RF_157,RandomForest_r157,1.875,194.78125,458,7722,1885364,1893544
RF_158,RandomForest_r158,2.1875,198.33984375,458,7710,2488941,2497109
RF_159,RandomForest_r159,2.015625,180.4375,458,7710,264064,272232
RF_160,RandomForest_r160,0.78125,150.93359375,456,7722,837673,845851
RF_161,RandomForest_r161,0.3125,178.67578125,458,7710,265184,273352
RF_162,RandomForest_r162,1.875,152.40234375,458,7710,1735882,1744050
RF_163,RandomForest_r163,0.78125,170.25,458,7710,835925,844093
RF_164,RandomForest_r164,1.25,196.56640625,458,7710,1377757,1385925
RF_165,RandomForest_r165,1.71875,152.59375,458,7710,1885340,1893508
RF_166,RandomForest_r166,2.65625,154.88671875,456,7710,2962248,2970414
RF_167,RandomForest_r167,2.03125,152.7265625,456,7710,2095731,2103897
RF_168,RandomForest_r168,2.8125,197.23828125,456,7710,2962248,2970414
RF_169,RandomForest_r169,0.3125,174.16796875,458,7710,174355,182523
RF_170,RandomForest_r170,0.9375,179.16796875,456,7710,837649,845815
RF_171,RandomForest_r171,1.71875,187.67578125,456,7710,1760646,1768812
RF_172,RandomForest_r172,1.5625,166.86328125,458,7710,1527855,1536023
RF_173,RandomForest_r173,0.625,164.875,456,7722,452824,461002
RF_174,RandomForest_r174,0.46875,181.47265625,458,7710,453467,461635
RF_175,RandomForest_r175,1.09375,150.3671875,458,7710,835925,844093
RF_176,RandomForest_r176,1.25,182.5546875,458,7710,1377757,1385925
RF_177,RandomForest_r177,1.71875,189.20703125,458,7710,2069847,2078015
RF_178,RandomForest_r178,1.71875,187.31640625,458,7710,1565944,1574112
RF_179,RandomForest_r179,0.9375,193.58203125,458,7710,835925,844093
RF_180,RandomForest_r180,0.15625,190.97265625,456,7710,264028,272194
RF_181,RandomForest_r181,0.3125,149.73046875,456,7710,452800,460966
RF_182,RandomForest_r182,0.46875,193.90234375,456,7710,837649,845815
RF_183,RandomForest_r183,1.875,184.5234375,458,7710,1565944,1574112
RF_184,RandomForest_r184,1.71875,186.2890625,458,7710,1626264,1634432
RF_185,RandomForest_r185,1.71875,185.5078125,458,7722,1425950,1434130
RF_186,RandomForest_r186,0.46875,165.73046875,456,7710,172239,180405
RF_187,RandomForest_r187,0.46875,187.03515625,458,7710,174355,182523
RF_188,RandomForest_r188,0.15625,149.3828125,458,7710,264064,272232
RF_189,RandomForest_r189,2.1875,184.515625,456,7710,2095731,2103897
RF_190,RandomForest_r190,0.46875,186.5859375,456,7710,264028,272194
RF_191,RandomForest_r191,1.875,196.31640625,458,7710,2069847,2078015
RF_192,RandomForest_r192,0.78125,188.796875,456,7710,452800,460966
RF_193,RandomForest_r193,1.40625,152.23046875,456,7710,1760646,1768812
RF_194,RandomForest_r194,1.25,193.515625,458,7710,1735882,1744050
RF_195,RandomForest_r195,2.1875,198.83984375,458,7710,2346994,2355162
RF_196,RandomForest_r196,1.25,171.109375,458,7710,1735882,1744050
RF_197,RandomForest_r197,2.1875,198.9140625,458,7710,2230674,2238842
RF_198,RandomForest_r198,1.71875,165.8515625,458,7710,1353757,1361925
RF_199,RandomForest_r199,1.71875,153.0546875,456,7710,2095731,2103897
RF_200,RandomForest_r200,0.3125,149.6484375,458,7710,265184,273352
NN_TORCH_0,NeuralNetTorch_c1,0.15625,503.78125,396,7710,224889,232995
NN_TORCH_1,NeuralNetTorch_c2,0.3125,503.94140625,414,7710,237946,246070
NN_TORCH_2,NeuralNetTorch_c3,0.15625,503.4609375,412,7710,91037,99159
NN_TORCH_3,NeuralNetTorch_c4,0.3125,503.49609375,429,7710,96736,104875
NN_TORCH_4,NeuralNetTorch_r1,0.3125,506.15234375,538,7710,530996,539244
NN_TORCH_5,NeuralNetTorch_r2,0.46875,503.39453125,537,7710,21834,30081
NN_TORCH_6,NeuralNetTorch_r3,0.46875,504.4375,538,7710,168796,177044
NN_TORCH_7,NeuralNetTorch_r4,0.15625,502.8203125,538,7710,33059,41307
NN_TORCH_8,NeuralNetTorch_r5,0.15625,503.31640625,537,7710,28174,36421
NN_TORCH_9,NeuralNetTorch_r6,0.15625,505.09765625,537,7710,564555,572802
NN_TORCH_10,NeuralNetTorch_r7,0.3125,503.20703125,537,7710,24787,33034
NN_TORCH_11,NeuralNetTorch_r8,0.3125,504.4140625,538,7710,187948,196196
NN_TORCH_12,NeuralNetTorch_r9,0.3125,504.4375,537,7710,165338,173585
NN_TORCH_13,NeuralNetTorch_r10,0.15625,504.03125,538,7710,228247,236495
NN_TORCH_14,NeuralNetTorch_r11,0.46875,504.390625,538,7710,339978,348226
NN_TORCH_15,NeuralNetTorch_r12,0.46875,503.99609375,539,7710,19241,27490
NN_TORCH_16,NeuralNetTorch_r13,0.625,504.21484375,538,7710,199621,207869
NN_TORCH_17,NeuralNetTorch_r14,0.3125,504.125,539,7710,24641,32890
NN_TORCH_18,NeuralNetTorch_r15,0.3125,503.66015625,538,7710,206565,214813
NN_TORCH_19,NeuralNetTorch_r16,0.15625,503.84375,539,7710,234647,242896
NN_TORCH_20,NeuralNetTorch_r17,0.46875,504.23828125,538,7710,56938,65186
NN_TORCH_21,NeuralNetTorch_r18,0.3125,503.703125,538,7710,21334,29582
NN_TORCH_22,NeuralNetTorch_r19,0.15625,503.8828125,539,7710,31122,39371
NN_TORCH_23,NeuralNetTorch_r20,0.46875,503.671875,539,7710,18521,26770
NN_TORCH_24,NeuralNetTorch_r21,0.3125,502.72265625,539,7710,28527,36776
NN_TORCH_25,NeuralNetTorch_r22,0.15625,506.1171875,538,7710,580039,588287
NN_TORCH_26,NeuralNetTorch_r23,0.625,504.1171875,538,7710,22795,31043
NN_TORCH_27,NeuralNetTorch_r24,0.15625,505.453125,538,7710,385472,393720
NN_TORCH_28,NeuralNetTorch_r25,0.46875,503.98046875,538,7710,177989,186237
NN_TORCH_29,NeuralNetTorch_r26,0.15625,504.296875,538,7710,87159,95407
NN_TORCH_30,NeuralNetTorch_r27,0.15625,503.53515625,539,7710,91492,99741
NN_TORCH_31,NeuralNetTorch_r28,0.15625,505.3515625,538,7710,499975,508223
NN_TORCH_32,NeuralNetTorch_r29,0.3125,508.359375,539,7710,1008841,1017090
NN_TORCH_33,NeuralNetTorch_r30,0.15625,505.21484375,538,7710,455793,464041
NN_TORCH_34,NeuralNetTorch_r31,0.3125,503.26171875,538,7710,103236,111484
NN_TORCH_35,NeuralNetTorch_r32,0.3125,503.28125,539,7710,18370,26619
NN_TORCH_36,NeuralNetTorch_r33,0.15625,503.08203125,539,7710,34290,42539
NN_TORCH_37,NeuralNetTorch_r34,0.3125,504.05859375,539,7710,58622,66871
NN_TORCH_38,NeuralNetTorch_r35,0.3125,504.4765625,539,7710,92471,100720
NN_TORCH_39,NeuralNetTorch_r36,0.3125,504.1640625,538,7710,37164,45412
NN_TORCH_40,NeuralNetTorch_r37,0.15625,504.00390625,538,7710,129333,137581
NN_TORCH_41,NeuralNetTorch_r38,0.3125,503.94140625,538,7710,229181,237429
NN_TORCH_42,NeuralNetTorch_r39,0.15625,503.92578125,538,7710,162269,170517
NN_TORCH_43,NeuralNetTorch_r40,0.3125,502.4140625,538,7710,30623,38871
NN_TORCH_44,NeuralNetTorch_r41,0.15625,503.9375,539,7710,41084,49333
NN_TORCH_45,NeuralNetTorch_r42,0.3125,507.109375,538,7710,764575,772823
NN_TORCH_46,NeuralNetTorch_r43,0.3125,503.5546875,538,7710,26234,34482
NN_TORCH_47,NeuralNetTorch_r44,0.46875,503.3515625,538,7710,28253,36501
NN_TORCH_48,NeuralNetTorch_r45,0.46875,503.42578125,538,7710,25295,33543
NN_TORCH_49,NeuralNetTorch_r46,0.3125,504.921875,538,7710,275829,284077
NN_TORCH_50,NeuralNetTorch_r47,0.15625,505.8984375,538,7710,490207,498455
NN_TORCH_51,NeuralNetTorch_r48,0.15625,503.66015625,539,7710,20603,28852
NN_TORCH_52,NeuralNetTorch_r49,0.15625,504.11328125,539,7710,118012,126261
NN_TORCH_53,NeuralNetTorch_r50,0.3125,504.34375,538,7710,26306,34554
NN_TORCH_54,NeuralNetTorch_r51,0.3125,504.0078125,540,7710,35452,43702
NN_TORCH_55,NeuralNetTorch_r52,0.15625,503.2734375,538,7710,29543,37791
NN_TORCH_56,NeuralNetTorch_r53,0.46875,504.2734375,539,7710,272621,280870
NN_TORCH_57,NeuralNetTorch_r54,0.3125,503.35546875,538,7710,37227,45475
NN_TORCH_58,NeuralNetTorch_r55,0.3125,503.10546875,538,7710,28679,36927
NN_TORCH_59,NeuralNetTorch_r56,0.46875,504.5234375,538,7710,317698,325946
NN_TORCH_60,NeuralNetTorch_r57,0.46875,507.31640625,539,7710,777240,785489
NN_TORCH_61,NeuralNetTorch_r58,0.15625,506.23828125,539,7710,511464,519713
NN_TORCH_62,NeuralNetTorch_r59,0.15625,508.82421875,538,7710,907738,915986
NN_TORCH_63,NeuralNetTorch_r60,0.3125,504.32421875,538,7710,41092,49340
NN_TORCH_64,NeuralNetTorch_r61,0.3125,506.8515625,539,7710,650506,658755
NN_TORCH_65,NeuralNetTorch_r62,0.3125,502.6015625,538,7710,28607,36855
NN_TORCH_66,NeuralNetTorch_r63,0.15625,504.29296875,538,7710,260047,268295
NN_TORCH_67,NeuralNetTorch_r64,0.3125,504.296875,539,7710,198470,206719
NN_TORCH_68,NeuralNetTorch_r65,0.3125,503.8515625,539,7710,57211,65460
NN_TORCH_69,NeuralNetTorch_r66,0.3125,504.140625,538,7710,96619,104867
NN_TORCH_70,NeuralNetTorch_r67,0.3125,503.96484375,539,7710,38971,47220
NN_TORCH_71,NeuralNetTorch_r68,0.15625,505.05078125,538,7710,201368,209616
NN_TORCH_72,NeuralNetTorch_r69,0.15625,506.6484375,538,7710,545983,554231
NN_TORCH_73,NeuralNetTorch_r70,0.3125,503.32421875,538,7710,26410,34658
NN_TORCH_74,NeuralNetTorch_r71,0.15625,502.69921875,539,7710,29103,37352
NN_TORCH_75,NeuralNetTorch_r72,0.15625,503.86328125,538,7710,17777,26025
NN_TORCH_76,NeuralNetTorch_r73,0.3125,503.390625,539,7710,65274,73523
NN_TORCH_77,NeuralNetTorch_r74,0.46875,505.66015625,538,7710,479530,487778
NN_TORCH_78,NeuralNetTorch_r75,0.15625,503.53515625,538,7710,34370,42618
NN_TORCH_79,NeuralNetTorch_r76,0.15625,503.72265625,539,7710,30834,39083
NN_TORCH_80,NeuralNetTorch_r77,0.3125,506.96875,538,7710,764575,772823
NN_TORCH_81,NeuralNetTorch_r78,0.3125,504.1171875,539,7710,353722,361971
NN_TORCH_82,NeuralNetTorch_r79,0.15625,504.21484375,538,7710,178822,187070
NN_TORCH_83,NeuralNetTorch_r80,0.15625,503.62109375,538,7710,27386,35634
NN_TORCH_84,NeuralNetTorch_r81,0.15625,503.8359375,538,7710,187157,195405
NN_TORCH_85,NeuralNetTorch_r82,0.3125,506.21484375,539,7710,549287,557536
NN_TORCH_86,NeuralNetTorch_r83,0.3125,504.81640625,539,7710,108205,116454
NN_TORCH_87,NeuralNetTorch_r84,0.3125,503.515625,538,7710,22342,30590
NN_TORCH_88,NeuralNetTorch_r85,0.15625,504.9375,538,7710,128600,136848
NN_TORCH_89,NeuralNetTorch_r86,0.46875,504.69140625,539,7710,322082,330331
NN_TORCH_90,NeuralNetTorch_r87,0.3125,504.19140625,539,7710,104909,113158
NN_TORCH_91,NeuralNetTorch_r88,0.3125,504.58203125,539,7710,300288,308537
NN_TORCH_92,NeuralNetTorch_r89,0.3125,506.37890625,539,7710,529719,537968
NN_TORCH_93,NeuralNetTorch_r90,0.625,503.6640625,539,7710,43725,51974
NN_TORCH_94,NeuralNetTorch_r91,0.3125,507.9140625,539,7710,1040602,1048851
NN_TORCH_95,NeuralNetTorch_r92,0.625,505.08203125,538,7710,260047,268295
NN_TORCH_96,NeuralNetTorch_r93,0.3125,502.8203125,539,7710,16430,24679
NN_TORCH_97,NeuralNetTorch_r94,0.3125,503.671875,538,7710,174495,182743
NN_TORCH_98,NeuralNetTorch_r95,0.15625,504.2890625,539,7710,174039,182288
NN_TORCH_99,NeuralNetTorch_r96,0.15625,505.07421875,538,7710,299672,307920
NN_TORCH_100,NeuralNetTorch_r97,0.15625,506.921875,538,7710,788719,796967
NN_TORCH_101,NeuralNetTorch_r98,0.3125,504.90234375,538,7710,258160,266408
NN_TORCH_102,NeuralNetTorch_r99,0.3125,503.4453125,539,7710,21207,29456
NN_TORCH_103,NeuralNetTorch_r100,0.15625,503.71875,540,7710,20872,29122
NN_TORCH_104,NeuralNetTorch_r101,0.3125,507.19140625,540,7710,704093,712343
NN_TORCH_105,NeuralNetTorch_r102,0.3125,504.625,540,7710,37336,45586
NN_TORCH_106,NeuralNetTorch_r103,0.3125,505.234375,540,7710,360916,369166
NN_TORCH_107,NeuralNetTorch_r104,0.46875,504.13671875,540,7710,22053,30303
NN_TORCH_108,NeuralNetTorch_r105,0.3125,504.71875,540,7710,64752,73002
NN_TORCH_109,NeuralNetTorch_r106,0.46875,504.87890625,540,7710,382094,390344
NN_TORCH_110,NeuralNetTorch_r107,0.3125,502.8984375,539,7710,25011,33260
NN_TORCH_111,NeuralNetTorch_r108,0.15625,504.06640625,540,7710,21621,29871
NN_TORCH_112,NeuralNetTorch_r109,0.3125,504.12109375,539,7710,52823,61072
NN_TORCH_113,NeuralNetTorch_r110,0.46875,504.31640625,539,7710,103151,111400
NN_TORCH_114,NeuralNetTorch_r111,0.46875,503.8046875,539,7710,145664,153913
NN_TORCH_115,NeuralNetTorch_r112,0.3125,504.8515625,539,7710,109113,117362
NN_TORCH_116,NeuralNetTorch_r113,0.46875,504.24609375,539,7710,200803,209052
NN_TORCH_117,NeuralNetTorch_r114,0.3125,506.5078125,539,7710,717443,725692
NN_TORCH_118,NeuralNetTorch_r115,0.3125,505.265625,540,7710,441219,449469
NN_TORCH_119,NeuralNetTorch_r116,0.15625,503.48046875,540,7710,28791,37041
NN_TORCH_120,NeuralNetTorch_r117,0.3125,504.59375,540,7710,226554,234804
NN_TORCH_121,NeuralNetTorch_r118,0.3125,504.27734375,540,7710,87155,95405
NN_TORCH_122,NeuralNetTorch_r119,0.3125,503.8046875,539,7710,20549,28798
NN_TORCH_123,NeuralNetTorch_r120,0.3125,504.02734375,540,7710,39336,47586
NN_TORCH_124,NeuralNetTorch_r121,0.3125,509.3671875,540,7710,1016486,1024736
NN_TORCH_125,NeuralNetTorch_r122,0.15625,504.2578125,540,7710,35008,43258
NN_TORCH_126,NeuralNetTorch_r123,0.15625,504.07421875,540,7710,32250,40500
NN_TORCH_127,NeuralNetTorch_r124,0.46875,506.03515625,539,7710,316611,324860
NN_TORCH_128,NeuralNetTorch_r125,0.15625,504.63671875,539,7710,95417,103666
NN_TORCH_129,NeuralNetTorch_r126,0.3125,503.75390625,540,7710,218275,226525
NN_TORCH_130,NeuralNetTorch_r127,0.625,507.68359375,539,7710,783276,791525
NN_TORCH_131,NeuralNetTorch_r128,0.46875,503.8984375,539,7710,138760,147009
NN_TORCH_132,NeuralNetTorch_r129,0.15625,505.04296875,539,7710,99132,107381
NN_TORCH_133,NeuralNetTorch_r130,0.3125,504.89453125,539,7710,94667,102916
NN_TORCH_134,NeuralNetTorch_r131,0.46875,504.1796875,539,7710,32358,40607
NN_TORCH_135,NeuralNetTorch_r132,0.3125,506.05859375,540,7710,627771,636021
NN_TORCH_136,NeuralNetTorch_r133,0.46875,504.8515625,540,7710,288868,297118
NN_TORCH_137,NeuralNetTorch_r134,0.3125,505.8671875,540,7710,361179,369429
NN_TORCH_138,NeuralNetTorch_r135,0.15625,505.1328125,539,7710,380797,389046
NN_TORCH_139,NeuralNetTorch_r136,0.3125,503.9296875,539,7710,236563,244812
NN_TORCH_140,NeuralNetTorch_r137,0.15625,503.6328125,539,7710,23623,31872
NN_TORCH_141,NeuralNetTorch_r138,0.46875,503.40234375,539,7710,16941,25190
NN_TORCH_142,NeuralNetTorch_r139,0.15625,504.91015625,540,7710,173434,181684
NN_TORCH_143,NeuralNetTorch_r140,0.3125,503.66015625,539,7710,55975,64224
NN_TORCH_144,NeuralNetTorch_r141,0.3125,503.88671875,540,7710,97256,105506
NN_TORCH_145,NeuralNetTorch_r142,0.15625,506.8671875,540,7710,820645,828895
NN_TORCH_146,NeuralNetTorch_r143,0.3125,508.328125,539,7710,778461,786710
NN_TORCH_147,NeuralNetTorch_r144,0.3125,504.4765625,539,7710,63896,72145
NN_TORCH_148,NeuralNetTorch_r145,0.15625,504.93359375,539,7710,110852,119101
NN_TORCH_149,NeuralNetTorch_r146,0.15625,503.96875,540,7710,280801,289051
NN_TORCH_150,NeuralNetTorch_r147,0.46875,503.28125,540,7710,21258,29508
NN_TORCH_151,NeuralNetTorch_r148,0.3125,505.3125,540,7710,428308,436558
NN_TORCH_152,NeuralNetTorch_r149,0.3125,504.99609375,539,7710,104892,113141
NN_TORCH_153,NeuralNetTorch_r150,0.3125,504.53515625,539,7710,174051,182300
NN_TORCH_154,NeuralNetTorch_r151,0.3125,503.7421875,539,7710,231809,240058
NN_TORCH_155,NeuralNetTorch_r152,0.3125,505.67578125,540,7710,288396,296646
NN_TORCH_156,NeuralNetTorch_r153,0.3125,505.62109375,539,7710,407361,415610
NN_TORCH_157,NeuralNetTorch_r154,0.15625,507.890625,539,7710,826116,834365
NN_TORCH_158,NeuralNetTorch_r155,0.46875,504.5078125,540,7710,54694,62944
NN_TORCH_159,NeuralNetTorch_r156,0.15625,506.03515625,539,7710,419901,428150
NN_TORCH_160,NeuralNetTorch_r157,0.15625,508.83984375,540,7710,900989,909239
NN_TORCH_161,NeuralNetTorch_r158,0.3125,504.69921875,539,7710,241122,249371
NN_TORCH_162,NeuralNetTorch_r159,0.3125,503.80078125,540,7710,44615,52865
NN_TORCH_163,NeuralNetTorch_r160,0.15625,509.34375,539,7710,907742,915991
NN_TORCH_164,NeuralNetTorch_r161,0.3125,503.36328125,540,7710,44615,52865
NN_TORCH_165,NeuralNetTorch_r162,0.15625,504.47265625,540,7710,89049,97299
NN_TORCH_166,NeuralNetTorch_r163,0.3125,504.08984375,539,7710,26093,34342
NN_TORCH_167,NeuralNetTorch_r164,0.15625,502.99609375,540,7710,26875,35125
NN_TORCH_168,NeuralNetTorch_r165,0.15625,503.27734375,540,7710,22014,30264
NN_TORCH_169,NeuralNetTorch_r166,0.3125,503.54296875,540,7710,28335,36585
NN_TORCH_170,NeuralNetTorch_r167,0.15625,502.87890625,539,7710,27387,35636
NN_TORCH_171,NeuralNetTorch_r168,0.3125,504.1953125,540,7710,213601,221851
NN_TORCH_172,NeuralNetTorch_r169,0.15625,503.44921875,540,7710,31673,39923
NN_TORCH_173,NeuralNetTorch_r170,0.15625,504.19921875,539,7710,308733,316982
NN_TORCH_174,NeuralNetTorch_r171,0.15625,503.82421875,540,7710,87303,95553
NN_TORCH_175,NeuralNetTorch_r172,0.3125,504.1875,540,7710,264675,272925
NN_TORCH_176,NeuralNetTorch_r173,0.15625,504.296875,540,7710,27526,35776
NN_TORCH_177,NeuralNetTorch_r174,0.15625,505.13671875,539,7710,484982,493231
NN_TORCH_178,NeuralNetTorch_r175,0.15625,502.81640625,540,7710,16722,24972
NN_TORCH_179,NeuralNetTorch_r176,0.15625,504.8515625,540,7710,221403,229653
NN_TORCH_180,NeuralNetTorch_r177,0.15625,504.609375,539,7710,56282,64531
NN_TORCH_181,NeuralNetTorch_r178,0.3125,503.2109375,540,7710,20250,28500
NN_TORCH_182,NeuralNetTorch_r179,0.3125,504.41796875,540,7710,75203,83453
NN_TORCH_183,NeuralNetTorch_r180,0.46875,504.73828125,539,7710,127489,135738
NN_TORCH_184,NeuralNetTorch_r181,0.15625,504.39453125,539,7710,127489,135738
NN_TORCH_185,NeuralNetTorch_r182,0.15625,503.171875,540,7710,20178,28428
NN_TORCH_186,NeuralNetTorch_r183,0.46875,506.87109375,539,7710,549299,557548
NN_TORCH_187,NeuralNetTorch_r184,0.15625,504.73828125,539,7710,222609,230858
NN_TORCH_188,NeuralNetTorch_r185,0.3125,505.3359375,540,7710,318148,326398
NN_TORCH_189,NeuralNetTorch_r186,0.3125,507.12890625,540,7710,638643,646893
NN_TORCH_190,NeuralNetTorch_r187,0.3125,504.82421875,539,7710,248873,257122
NN_TORCH_191,NeuralNetTorch_r188,0.3125,505.21875,540,7710,295417,303667
NN_TORCH_192,NeuralNetTorch_r189,0.3125,505.86328125,540,7710,606774,615024
NN_TORCH_193,NeuralNetTorch_r190,0.46875,506.83984375,540,7710,550083,558333
NN_TORCH_194,NeuralNetTorch_r191,0.3125,503.76953125,539,7710,30270,38519
NN_TORCH_195,NeuralNetTorch_r192,0.15625,506.40625,539,7710,513731,521980
NN_TORCH_196,NeuralNetTorch_r193,0.15625,503.8515625,539,7710,164601,172850
NN_TORCH_197,NeuralNetTorch_r194,0.3125,505.11328125,540,7710,167370,175620
NN_TORCH_198,NeuralNetTorch_r195,0.3125,503.015625,540,7710,27091,35341
NN_TORCH_199,NeuralNetTorch_r196,0.15625,503.3671875,539,7710,23354,31603
NN_TORCH_200,NeuralNetTorch_r197,0.15625,503.07421875,539,7710,33003,41252
NN_TORCH_201,NeuralNetTorch_r198,0.15625,505.23046875,540,7710,297564,305814
NN_TORCH_202,NeuralNetTorch_r199,0.15625,504.328125,539,7710,315251,323500
NN_TORCH_203,NeuralNetTorch_r200,0.3125,504.44140625,539,7710,128604,136853
LR_0,LinearModel_c1,0.15625,142.38671875,390,7710,10806,18906
LR_1,LinearModel_c2,0.16983695652173914,142.23046875,414,7710,10825,18949
LR_2,LinearModel_r1,0.16983695652173914,141.91796875,474,7710,10895,19079
LR_3,LinearModel_r2,0.16983695652173914,142.07421875,472,7710,10893,19075
LR_4,LinearModel_r3,0.15625,141.76171875,480,7710,10909,19099
LR_5,LinearModel_r4,0.15625,142.23046875,482,7710,10911,19103
LR_6,LinearModel_r5,0.15625,141.91796875,482,7710,10911,19103
LR_7,LinearModel_r6,0.16983695652173914,141.47265625,480,7710,10909,19099
LR_8,LinearModel_r7,0.16983695652173914,142.41015625,474,7710,10895,19079
LR_9,LinearModel_r8,0.16983695652173914,141.78515625,480,7710,10909,19099
LR_10,LinearModel_r9,0.16983695652173914,142.09765625,472,7710,10893,19075
LR_11,LinearModel_r10,0.16983695652173914,142.09765625,475,7710,10899,19084
LR_12,LinearModel_r11,0.16983695652173914,141.94140625,473,7710,10897,19080
LR_13,LinearModel_r12,0.16983695652173914,142.09765625,475,7710,10899,19084
LR_14,LinearModel_r13,0.16983695652173914,142.07421875,475,7710,10899,19084
LR_15,LinearModel_r14,0.16983695652173914,141.78515625,483,7710,10915,19108
LR_16,LinearModel_r15,0.16983695652173914,141.94140625,483,7710,10915,19108
LR_17,LinearModel_r16,0.16983695652173914,141.80078125,481,7710,10913,19104
LR_18,LinearModel_r17,0.16983695652173914,142.11328125,481,7710,10913,19104
LR_19,LinearModel_r18,0.15625,141.95703125,481,7710,10913,19104
LR_20,LinearModel_r19,0.15625,141.64453125,475,7710,10899,19084
LR_21,LinearModel_r20,0.16983695652173914,142.26953125,481,7710,10913,19104
LR_22,LinearModel_r21,0.16983695652173914,141.80078125,481,7710,10913,19104
LR_23,LinearModel_r22,0.16983695652173914,141.80078125,481,7710,10913,19104
LR_24,LinearModel_r23,0.15625,141.80078125,483,7710,10915,19108
LR_25,LinearModel_r24,0.15625,141.80078125,481,7710,10913,19104
LR_26,LinearModel_r25,0.16983695652173914,141.48828125,481,7710,10913,19104
LR_27,LinearModel_r26,0.15625,141.66796875,473,7710,10897,19080
LR_28,LinearModel_r27,0.16983695652173914,142.08984375,483,7710,10915,19108
LR_29,LinearModel_r28,0.15625,141.66796875,483,7710,10915,19108
LR_30,LinearModel_r29,0.3125,142.13671875,483,7710,10915,19108
LR_31,LinearModel_r30,0.16983695652173914,141.66796875,473,7710,10897,19080
LR_32,LinearModel_r31,0.15625,141.82421875,481,7710,10913,19104
LR_33,LinearModel_r32,0.15625,141.82421875,483,7710,10915,19108
LR_34,LinearModel_r33,0.16983695652173914,142.13671875,475,7710,10899,19084
LR_35,LinearModel_r34,0.15625,141.82421875,481,7710,10913,19104
LR_36,LinearModel_r35,0.16983695652173914,142.1015625,483,7710,10915,19108
LR_37,LinearModel_r36,0.16983695652173914,141.84375,483,7710,10915,19108
LR_38,LinearModel_r37,0.15625,142.3125,475,7710,10899,19084
LR_39,LinearModel_r38,0.15625,142.46875,483,7710,10915,19108
LR_40,LinearModel_r39,0.3125,142.0,481,7710,10913,19104
LR_41,LinearModel_r40,0.16983695652173914,142.3125,483,7710,10915,19108
LR_42,LinearModel_r41,0.15625,142.0,483,7710,10915,19108
LR_43,LinearModel_r42,0.16983695652173914,142.47265625,483,7710,10915,19108
LR_44,LinearModel_r43,0.15625,142.31640625,483,7710,10915,19108
LR_45,LinearModel_r44,0.15625,142.00390625,483,7710,10915,19108
LR_46,LinearModel_r45,0.15625,142.16015625,481,7710,10913,19104
LR_47,LinearModel_r46,0.16983695652173914,141.87109375,481,7710,10913,19104
LR_48,LinearModel_r47,0.16983695652173914,141.87109375,483,7710,10915,19108
LR_49,LinearModel_r48,0.15625,142.02734375,481,7710,10913,19104
LR_50,LinearModel_r49,0.15625,142.18359375,481,7710,10913,19104
LR_51,LinearModel_r50,0.16983695652173914,142.02734375,483,7710,10915,19108
GBM_0,LightGBM_c1,0.3125,161.71484375,391,7710,280553,288654
GBM_1,LightGBM_c2,0.15625,163.12109375,407,7710,536224,544341
GBM_2,LightGBM_c3,0.3125,167.80859375,481,7710,489822,498013
GBM_3,LightGBM_c4,0.3125,165.30859375,496,7710,81836,90042
GBM_4,LightGBM_r1,0.15625,165.46484375,496,7710,266710,274916
GBM_5,LightGBM_r2,0.15625,163.0,496,7710,22571,30777
GBM_6,LightGBM_r3,0.3125,162.375,496,7722,109635,117853
GBM_7,LightGBM_r4,0.3125,163.15625,496,7710,14191,22397
GBM_8,LightGBM_r5,0.15625,168.625,496,7722,15376,23594
GBM_9,LightGBM_r6,0.46875,175.1875,496,7722,193562,201780
GBM_10,LightGBM_r7,0.3125,168.46875,496,7710,46454,54660
GBM_11,LightGBM_r8,0.3125,162.375,496,7722,159136,167354
GBM_12,LightGBM_r9,0.15625,165.1875,496,7710,17006,25212
GBM_13,LightGBM_r10,0.15625,161.28125,497,7722,15490,23709
GBM_14,LightGBM_r11,0.15625,165.96875,497,7710,22722,30929
GBM_15,LightGBM_r12,0.15625,162.69921875,497,7722,67202,75421
GBM_16,LightGBM_r13,0.3125,159.84765625,497,7710,14498,22705
GBM_17,LightGBM_r14,0.3125,161.8984375,497,7722,36979,45198
GBM_18,LightGBM_r15,0.3125,162.08203125,497,7710,627923,636130
GBM_19,LightGBM_r16,0.15625,167.39453125,497,7710,372622,380829
GBM_20,LightGBM_r17,0.3125,169.42578125,497,7722,52524,60743
GBM_21,LightGBM_r18,0.15625,161.14453125,497,7710,23131,31338
GBM_22,LightGBM_r19,0.15625,163.95703125,497,7722,34077,42296
GBM_23,LightGBM_r20,0.46875,172.08203125,497,7710,473325,481532
GBM_24,LightGBM_r21,0.3125,166.92578125,497,7722,13771,21990
GBM_25,LightGBM_r22,0.46875,168.51171875,497,7710,14922,23129
GBM_26,LightGBM_r23,0.46875,163.04296875,497,7722,15489,23708
GBM_27,LightGBM_r24,0.15625,169.91796875,497,7722,13192,21411
GBM_28,LightGBM_r25,0.15625,162.10546875,497,7710,14095,22302
GBM_29,LightGBM_r26,0.3125,159.91796875,497,7722,15072,23291
GBM_30,LightGBM_r27,0.46875,160.85546875,497,7710,87296,95503
GBM_31,LightGBM_r28,0.15625,163.51171875,497,7710,13179,21386
GBM_32,LightGBM_r29,0.3125,171.32421875,497,7722,47269,55488
GBM_33,LightGBM_r30,0.15625,163.51171875,497,7722,13759,21978
GBM_34,LightGBM_r31,0.46875,172.26171875,497,7710,110456,118663
GBM_35,LightGBM_r32,0.46875,165.71484375,497,7710,13755,21962
GBM_36,LightGBM_r33,0.15625,171.96484375,497,7722,363176,371395
GBM_37,LightGBM_r34,0.3125,175.98046875,497,7710,311304,319511
GBM_38,LightGBM_r35,0.3125,172.74609375,497,7722,379415,387634
GBM_39,LightGBM_r36,0.3125,163.05859375,497,7710,20119,28326
GBM_40,LightGBM_r37,0.3125,163.37109375,497,7722,14560,22779
GBM_41,LightGBM_r38,0.15625,167.58984375,497,7710,17705,25912
GBM_42,LightGBM_r39,0.15625,161.02734375,497,7722,15224,23443
GBM_43,LightGBM_r40,0.3125,160.08984375,497,7710,74756,82963
GBM_44,LightGBM_r41,0.15625,173.21875,497,7722,367443,375662
GBM_45,LightGBM_r42,0.15625,173.0859375,497,7710,368183,376390
GBM_46,LightGBM_r43,0.3125,164.9609375,497,7722,686994,695213
GBM_47,LightGBM_r44,0.15625,167.7734375,497,7710,15513,23720
GBM_48,LightGBM_r45,0.3125,165.875,497,7710,14215,22422
GBM_49,LightGBM_r46,0.3125,172.4609375,497,7722,201940,210159
GBM_50,LightGBM_r47,0.3125,173.3984375,497,7722,305013,313232
GBM_51,LightGBM_r48,0.3125,161.3671875,497,7710,44433,52640
GBM_52,LightGBM_r49,0.3125,159.8046875,497,7722,68871,77090
GBM_53,LightGBM_r50,0.46875,182.1484375,497,7710,794105,802312
GBM_54,LightGBM_r51,0.3125,164.4921875,497,7722,13534,21753
GBM_55,LightGBM_r52,0.3125,162.7890625,497,7710,13590,21797
GBM_56,LightGBM_r53,0.15625,160.8828125,497,7722,48055,56274
GBM_57,LightGBM_r54,0.15625,163.1015625,497,7710,66850,75057
GBM_58,LightGBM_r55,0.15625,170.97265625,497,7710,1391182,1399389
GBM_59,LightGBM_r56,0.3125,167.0078125,497,7710,20274,28481
GBM_60,LightGBM_r57,0.3125,163.5703125,497,7710,13182,21389
GBM_61,LightGBM_r58,0.3125,167.40625,497,7722,448218,456437
GBM_62,LightGBM_r59,0.15625,180.7578125,497,7710,412861,421068
GBM_63,LightGBM_r60,0.3125,164.6640625,497,7710,28147,36354
GBM_64,LightGBM_r61,0.15625,165.1328125,497,7722,585239,593458
GBM_65,LightGBM_r62,0.15625,164.99609375,497,7710,98947,107154
GBM_66,LightGBM_r63,0.3125,165.703125,497,7710,991717,999924
GBM_67,LightGBM_r64,0.15625,170.30859375,497,7710,16065,24272
GBM_68,LightGBM_r65,0.15625,165.46484375,497,7722,739046,747265
GBM_69,LightGBM_r66,0.15625,163.12109375,497,7710,13175,21382
GBM_70,LightGBM_r67,0.15625,166.55859375,497,7722,108920,117139
GBM_71,LightGBM_r68,0.15625,163.58984375,497,7710,15141,23348
GBM_72,LightGBM_r69,0.15625,170.46484375,497,7710,16782,24989
GBM_73,LightGBM_r70,0.15625,161.40234375,497,7722,13307,21526
GBM_74,LightGBM_r71,0.3125,181.08984375,497,7722,981720,989939
GBM_75,LightGBM_r72,0.46875,164.07421875,497,7710,15415,23622
GBM_76,LightGBM_r73,0.3125,168.91796875,497,7710,32126,40333
GBM_77,LightGBM_r74,0.3125,161.88671875,497,7722,22883,31102
GBM_78,LightGBM_r75,0.15625,160.32421875,497,7710,14944,23151
GBM_79,LightGBM_r76,0.15625,169.54296875,497,7722,22665,30884
GBM_80,LightGBM_r77,0.3125,163.29296875,497,7710,53783,61990
GBM_81,LightGBM_r78,0.3125,176.26171875,497,7722,195866,204085
GBM_82,LightGBM_r79,0.3125,164.33203125,497,7710,14740,22947
GBM_83,LightGBM_r80,0.46875,165.16796875,497,7722,15649,23868
GBM_84,LightGBM_r81,0.15625,171.09375,497,7710,1428951,1437158
GBM_85,LightGBM_r82,0.15625,168.0078125,497,7710,15194,23401
GBM_86,LightGBM_r83,0.46875,162.5390625,497,7710,15634,23841
GBM_87,LightGBM_r84,0.3125,166.9140625,497,7722,26367,34586
GBM_88,LightGBM_r85,0.15625,170.8203125,497,7722,213784,222003
GBM_89,LightGBM_r86,0.15625,166.6015625,497,7710,259696,267903
GBM_90,LightGBM_r87,0.15625,167.33984375,497,7722,13642,21861
GBM_91,LightGBM_r88,0.3125,165.5078125,497,7710,18008,26215
GBM_92,LightGBM_r89,0.3125,165.9765625,497,7722,25798,34017
GBM_93,LightGBM_r90,0.15625,163.3203125,497,7710,255775,263982
GBM_94,LightGBM_r91,0.3125,170.8203125,497,7722,66838,75057
GBM_95,LightGBM_r92,0.15625,163.02734375,497,7710,13285,21492
GBM_96,LightGBM_r93,0.15625,167.08984375,497,7722,255671,263890
GBM_97,LightGBM_r94,0.46875,160.37109375,497,7710,84420,92627
GBM_98,LightGBM_r95,0.3125,160.05859375,497,7722,19532,27751
GBM_99,LightGBM_r96,0.3125,159.58984375,497,7710,14367,22574
GBM_100,LightGBM_r97,0.15625,185.83984375,497,7722,463835,472054
GBM_101,LightGBM_r98,0.3125,160.52734375,497,7722,14088,22307
GBM_102,LightGBM_r99,0.15625,168.65234375,497,7710,18008,26215
GBM_103,LightGBM_r100,0.15625,166.46484375,498,7722,14417,22637
GBM_104,LightGBM_r101,0.3125,164.98828125,498,7710,13949,22157
GBM_105,LightGBM_r102,0.15625,176.1640625,498,7722,234540,242760
GBM_106,LightGBM_r103,0.46875,172.4140625,498,7710,161685,169893
GBM_107,LightGBM_r104,0.3125,164.9140625,498,7722,51068,59288
GBM_108,LightGBM_r105,0.3125,166.9453125,498,7710,152255,160463
GBM_109,LightGBM_r106,0.3125,159.7578125,498,7722,17315,25535
GBM_110,LightGBM_r107,0.3125,162.2578125,498,7710,32011,40219
GBM_111,LightGBM_r108,0.46875,163.6640625,498,7722,13203,21423
GBM_112,LightGBM_r109,0.15625,164.2890625,498,7722,13204,21424
GBM_113,LightGBM_r110,0.15625,166.7890625,498,7710,138484,146692
GBM_114,LightGBM_r111,0.3125,172.1015625,498,7722,331509,339729
GBM_115,LightGBM_r112,0.15625,167.90234375,498,7710,14186,22394
GBM_116,LightGBM_r113,0.3125,180.55859375,498,7722,449967,458187
GBM_117,LightGBM_r114,0.3125,163.99609375,498,7710,46664,54872
GBM_118,LightGBM_r115,0.3125,164.30859375,498,7722,296555,304775
GBM_119,LightGBM_r116,0.15625,164.62109375,498,7710,20160,28368
GBM_120,LightGBM_r117,0.15625,163.68359375,498,7710,15466,23674
GBM_121,LightGBM_r118,0.15625,160.08984375,498,7722,14111,22331
GBM_122,LightGBM_r119,0.3125,165.40234375,498,7710,15059,23267
GBM_123,LightGBM_r120,0.15625,163.68359375,498,7722,14438,22658
GBM_124,LightGBM_r121,0.3125,177.27734375,498,7722,860439,868659
GBM_125,LightGBM_r122,0.46875,171.359375,498,7710,1098927,1107135
GBM_126,LightGBM_r123,0.15625,168.12109375,498,7710,927340,935548
GBM_127,LightGBM_r124,0.3125,167.1328125,498,7710,23219,31427
GBM_128,LightGBM_r125,0.3125,168.5390625,498,7722,14989,23209
GBM_129,LightGBM_r126,0.15625,165.8828125,498,7710,13997,22205
GBM_130,LightGBM_r127,0.3125,163.8515625,498,7722,13311,21531
GBM_131,LightGBM_r128,0.46875,161.3515625,498,7710,30202,38410
GBM_132,LightGBM_r129,0.15625,164.61328125,498,7722,18464,26684
GBM_133,LightGBM_r130,0.15625,163.5390625,498,7722,14016,22236
GBM_134,LightGBM_r131,0.15625,161.0390625,498,7710,18835,27043
GBM_135,LightGBM_r132,0.3125,162.32421875,498,7722,34648,42868
GBM_136,LightGBM_r133,0.3125,164.04296875,498,7710,93157,101365
GBM_137,LightGBM_r134,0.3125,163.92578125,498,7710,597687,605895
GBM_138,LightGBM_r135,0.46875,182.63671875,498,7722,486728,494948
GBM_139,LightGBM_r136,0.3125,163.88671875,498,7710,14216,22424
GBM_140,LightGBM_r137,0.46875,160.2265625,498,7722,13320,21540
GBM_141,LightGBM_r138,0.15625,168.57421875,498,7710,265529,273737
GBM_142,LightGBM_r139,0.3125,179.98046875,498,7722,437767,445987
GBM_143,LightGBM_r140,0.15625,166.85546875,498,7710,17183,25391
GBM_144,LightGBM_r141,0.3125,168.88671875,498,7722,14769,22989
GBM_145,LightGBM_r142,0.46875,171.3984375,498,7710,207810,216018
GBM_146,LightGBM_r143,0.3125,184.875,498,7710,1473144,1481352
GBM_147,LightGBM_r144,0.46875,165.78125,498,7710,13992,22200
GBM_148,LightGBM_r145,0.3125,162.1796875,498,7722,365262,373482
GBM_149,LightGBM_r146,0.3125,160.6171875,498,7710,236079,244287
GBM_150,LightGBM_r147,0.15625,163.2734375,498,7722,13433,21653
GBM_151,LightGBM_r148,0.15625,159.9921875,498,7710,34408,42616
GBM_152,LightGBM_r149,0.15625,164.9921875,498,7722,27381,35601
GBM_153,LightGBM_r150,0.15625,160.93359375,498,7710,14414,22622
GBM_154,LightGBM_r151,0.15625,186.18359375,498,7722,1408867,1417087
GBM_155,LightGBM_r152,0.15625,161.66015625,498,7710,15121,23329
GBM_156,LightGBM_r153,0.3125,165.01171875,498,7722,401638,409858
GBM_157,LightGBM_r154,0.3125,160.328125,498,7710,13941,22149
GBM_158,LightGBM_r155,0.3125,163.765625,498,7722,13653,21873
GBM_159,LightGBM_r156,0.3125,165.64453125,498,7710,20721,28929
GBM_160,LightGBM_r157,0.3125,166.84765625,498,7722,212018,220238
GBM_161,LightGBM_r158,0.3125,160.80078125,498,7710,250308,258516
GBM_162,LightGBM_r159,0.3125,173.01953125,498,7722,1331780,1340000
GBM_163,LightGBM_r160,0.3125,162.67578125,498,7710,14572,22780
GBM_164,LightGBM_r161,0.15625,171.26953125,498,7722,25463,33683
GBM_165,LightGBM_r162,0.15625,168.3125,498,7710,189948,198156
GBM_166,LightGBM_r163,0.15625,160.5,498,7722,127681,135901
GBM_167,LightGBM_r164,0.15625,166.90625,498,7710,21934,30142
GBM_168,LightGBM_r165,0.15625,170.96875,498,7722,14198,22418
GBM_169,LightGBM_r166,0.3125,165.5,498,7710,188827,197035
GBM_170,LightGBM_r167,0.15625,160.03125,498,7722,14155,22375
GBM_171,LightGBM_r168,0.15625,168.9375,498,7710,44710,52918
GBM_172,LightGBM_r169,0.3125,169.71875,498,7722,24063,32283
GBM_173,LightGBM_r170,0.3125,162.515625,498,7710,537195,545403
GBM_174,LightGBM_r171,0.46875,162.53125,498,7710,15051,23259
GBM_175,LightGBM_r172,0.3125,167.73046875,498,7722,16109,24329
GBM_176,LightGBM_r173,0.15625,166.16796875,498,7710,169547,177755
GBM_177,LightGBM_r174,0.15625,168.19921875,498,7722,14418,22638
GBM_178,LightGBM_r175,0.3125,167.26171875,498,7710,598998,607206
GBM_179,LightGBM_r176,0.15625,169.44921875,498,7710,219292,227500
GBM_180,LightGBM_r177,0.46875,169.60546875,498,7722,14329,22549
GBM_181,LightGBM_r178,0.15625,178.19921875,498,7710,380702,388910
GBM_182,LightGBM_r179,0.15625,166.79296875,498,7722,186243,194463
GBM_183,LightGBM_r180,0.15625,168.82421875,498,7710,310397,318605
GBM_184,LightGBM_r181,0.3125,163.19921875,498,7710,679880,688088
GBM_185,LightGBM_r182,0.3125,162.4375,498,7710,25324,33532
GBM_186,LightGBM_r183,0.3125,168.375,498,7722,26285,34505
GBM_187,LightGBM_r184,0.46875,169.3125,498,7710,128638,136846
GBM_188,LightGBM_r185,0.15625,164.625,498,7722,1024889,1033109
GBM_189,LightGBM_r186,0.15625,164.15625,498,7710,13171,21379
GBM_190,LightGBM_r187,0.3125,164.3125,498,7710,17104,25312
GBM_191,LightGBM_r188,0.3125,165.71875,498,7722,106327,114547
GBM_192,LightGBM_r189,0.3125,169.0,498,7710,361526,369734
GBM_193,LightGBM_r190,0.15625,159.9375,498,7710,15123,23331
GBM_194,LightGBM_r191,0.46875,167.59375,498,7722,17675,25895
GBM_195,LightGBM_r192,0.3125,160.10546875,498,7710,36855,45063
GBM_196,LightGBM_r193,0.3125,168.38671875,498,7722,14003,22223
GBM_197,LightGBM_r194,0.3125,168.54296875,498,7722,16058,24278
GBM_198,LightGBM_r195,0.3125,175.859375,498,7710,1170767,1178975
GBM_199,LightGBM_r196,0.46875,165.73046875,498,7710,116799,125007
GBM_200,LightGBM_r197,0.3125,169.32421875,498,7710,16057,24265
GBM_201,LightGBM_r198,0.3125,162.60546875,498,7722,420642,428862
GBM_202,LightGBM_r199,0.3125,168.8046875,498,7710,14103,22311
GBM_203,LightGBM_r200,0.15625,172.1640625,498,7710,2022802,2031010
KNN_0,KNeighbors_c1,0.15625,143.07421875,412,7710,76006,84128
KNN_1,KNeighbors_c2,0.3125,143.40234375,413,7722,76031,84166
KNN_2,KNeighbors_r1,0.3125,142.93359375,434,7722,76065,84221
KNN_3,KNeighbors_r2,0.46875,143.24609375,435,7722,76066,84223
KNN_4,KNeighbors_r3,0.3125,143.08984375,435,7710,76042,84187
KNN_5,KNeighbors_r4,0.3125,142.62109375,434,7722,76065,84221
KNN_6,KNeighbors_r5,0.46875,143.40234375,435,7722,76066,84223
KNN_7,KNeighbors_r6,0.3125,142.93359375,434,7722,76065,84221
KNN_8,KNeighbors_r7,0.3125,142.62109375,434,7722,76065,84221
KNN_9,KNeighbors_r8,0.3125,143.04296875,434,7710,76041,84185
KNN_10,KNeighbors_r9,0.3125,143.24609375,435,7722,76066,84223
KNN_11,KNeighbors_r10,0.3125,142.62890625,435,7722,76069,84226
KNN_12,KNeighbors_r11,0.46875,143.25390625,435,7722,76069,84226
KNN_13,KNeighbors_r12,0.3125,143.02734375,435,7722,76069,84226
KNN_14,KNeighbors_r13,0.46875,142.94140625,435,7710,76045,84190
KNN_15,KNeighbors_r14,0.3125,143.56640625,436,7722,76070,84228
KNN_16,KNeighbors_r15,0.46875,143.09765625,435,7722,76069,84226
KNN_17,KNeighbors_r16,0.46875,143.56640625,436,7722,76070,84228
KNN_18,KNeighbors_r17,0.3125,143.56640625,436,7722,76070,84228
KNN_19,KNeighbors_r18,0.46875,142.62890625,436,7710,76046,84192
KNN_20,KNeighbors_r19,0.46875,143.56640625,436,7722,76070,84228
KNN_21,KNeighbors_r20,0.46875,143.2734375,436,7722,76070,84228
KNN_22,KNeighbors_r21,0.3125,143.1171875,436,7722,76070,84228
KNN_23,KNeighbors_r22,0.46875,143.4296875,435,7722,76069,84226
KNN_24,KNeighbors_r23,0.46875,142.9609375,435,7710,76045,84190
KNN_25,KNeighbors_r24,0.3125,142.8046875,435,7722,76069,84226
KNN_26,KNeighbors_r25,0.46875,142.9609375,435,7722,76069,84226
KNN_27,KNeighbors_r26,0.3125,142.9609375,435,7722,76069,84226
KNN_28,KNeighbors_r27,0.15625,143.1171875,436,7722,76070,84228
KNN_29,KNeighbors_r28,0.15625,143.2734375,436,7710,76046,84192
KNN_30,KNeighbors_r29,0.3125,143.4296875,436,7722,76070,84228
KNN_31,KNeighbors_r30,0.3125,142.98828125,435,7722,76069,84226
KNN_32,KNeighbors_r31,0.3125,143.30078125,436,7722,76070,84228
KNN_33,KNeighbors_r32,0.3125,143.45703125,436,7722,76070,84228
KNN_34,KNeighbors_r33,0.3125,142.83203125,435,7710,76045,84190
KNN_35,KNeighbors_r34,0.3125,143.14453125,436,7722,76070,84228
KNN_36,KNeighbors_r35,0.625,143.30078125,435,7722,76069,84226
KNN_37,KNeighbors_r36,0.46875,143.14453125,436,7722,76070,84228
KNN_38,KNeighbors_r37,0.625,143.45703125,436,7722,76070,84228
KNN_39,KNeighbors_r38,0.46875,143.61328125,436,7710,76046,84192
KNN_40,KNeighbors_r39,0.15625,143.14453125,435,7722,76069,84226
KNN_41,KNeighbors_r40,0.3125,142.5390625,436,7722,76070,84228
KNN_42,KNeighbors_r41,0.46875,143.1640625,435,7722,76069,84226
KNN_43,KNeighbors_r42,0.3125,143.3203125,436,7722,76070,84228
KNN_44,KNeighbors_r43,0.3125,143.1640625,435,7710,76045,84190
KNN_45,KNeighbors_r44,0.78125,143.0078125,435,7722,76069,84226
KNN_46,KNeighbors_r45,0.625,143.0078125,435,7722,76069,84226
KNN_47,KNeighbors_r46,0.3125,143.1640625,435,7722,76069,84226
KNN_48,KNeighbors_r47,0.46875,143.16796875,435,7710,76045,84190
KNN_49,KNeighbors_r48,0.625,143.32421875,436,7722,76070,84228
KNN_50,KNeighbors_r49,0.15625,143.32421875,436,7722,76070,84228
KNN_51,KNeighbors_r50,0.46875,143.17578125,435,7722,76069,84226
FT_TRANSFORMER_0,FTTransformer_c1,0.625,1236.66015625,402,7722,8542,16666
FT_TRANSFORMER_1,FTTransformer_c2,0.625,1236.80078125,572,7710,8682,16964
FT_TRANSFORMER_2,FTTransformer_c3,0.78125,1236.00390625,572,7710,8682,16964
FT_TRANSFORMER_3,FTTransformer_c4,0.625,1236.34375,572,7710,8682,16964
FT_TRANSFORMER_4,FTTransformer_c5,0.78125,1235.3046875,575,7710,8685,16970
FT_TRANSFORMER_5,FTTransformer_c6,0.78125,1235.20703125,573,7710,8683,16966
FT_TRANSFORMER_6,FTTransformer_c7,0.625,1235.1640625,573,7710,8683,16966
FASTAI_0,NeuralNetFastAI_c1,0.15625,509.35546875,394,7710,9238,17342
FASTAI_1,NeuralNetFastAI_r1,0.3125,508.6640625,480,7710,9336,17526
FASTAI_2,NeuralNetFastAI_r2,0.46875,508.65625,482,7710,9338,17530
FASTAI_3,NeuralNetFastAI_r3,0.15625,511.80078125,481,7710,9336,17527
FASTAI_4,NeuralNetFastAI_r4,0.3125,506.6640625,476,7710,9332,17518
FASTAI_5,NeuralNetFastAI_r5,0.46875,509.3671875,477,7710,9333,17520
FASTAI_6,NeuralNetFastAI_r6,0.3125,507.0546875,476,7710,9332,17518
FASTAI_7,NeuralNetFastAI_r7,0.3125,519.78515625,481,7710,9337,17528
FASTAI_8,NeuralNetFastAI_r8,0.15625,524.59375,481,7710,9337,17528
FASTAI_9,NeuralNetFastAI_r9,0.46875,509.41796875,477,7710,9333,17520
FASTAI_10,NeuralNetFastAI_r10,0.3125,505.0859375,477,7710,9336,17523
FASTAI_11,NeuralNetFastAI_r11,0.3125,520.07421875,481,7710,9339,17530
FASTAI_12,NeuralNetFastAI_r12,0.15625,518.6015625,482,7710,9341,17533
FASTAI_13,NeuralNetFastAI_r13,0.3125,506.51171875,482,7710,9341,17533
FASTAI_14,NeuralNetFastAI_r14,0.3125,511.91796875,482,7710,9340,17532
FASTAI_15,NeuralNetFastAI_r15,0.3125,506.47265625,480,7710,9339,17529
FASTAI_16,NeuralNetFastAI_r16,0.3125,507.0390625,479,7710,9337,17526
FASTAI_17,NeuralNetFastAI_r17,0.3125,508.88671875,483,7710,9342,17535
FASTAI_18,NeuralNetFastAI_r18,0.15625,505.41015625,478,7710,9337,17525
FASTAI_19,NeuralNetFastAI_r19,0.3125,509.234375,483,7710,9342,17535
FASTAI_20,NeuralNetFastAI_r20,0.3125,504.8984375,477,7710,9336,17523
FASTAI_21,NeuralNetFastAI_r21,0.15625,506.4609375,482,7710,9341,17533
FASTAI_22,NeuralNetFastAI_r22,0.46875,505.8984375,482,7710,9341,17533
FASTAI_23,NeuralNetFastAI_r23,0.3125,525.8515625,482,7710,9341,17533
FASTAI_24,NeuralNetFastAI_r24,0.3125,514.48828125,481,7710,9340,17531
FASTAI_25,NeuralNetFastAI_r25,0.3125,506.85546875,482,7710,9341,17533
FASTAI_26,NeuralNetFastAI_r26,0.46875,506.734375,482,7710,9341,17533
FASTAI_27,NeuralNetFastAI_r27,0.46875,509.23046875,483,7710,9342,17535
FASTAI_28,NeuralNetFastAI_r28,0.3125,509.6875,480,7710,9339,17529
FASTAI_29,NeuralNetFastAI_r29,0.15625,520.3515625,481,7710,9339,17530
FASTAI_30,NeuralNetFastAI_r30,0.3125,519.1953125,482,7710,9341,17533
FASTAI_31,NeuralNetFastAI_r31,0.3125,517.8125,482,7710,9341,17533
FASTAI_32,NeuralNetFastAI_r32,0.46875,508.234375,481,7710,9340,17531
FASTAI_33,NeuralNetFastAI_r33,0.46875,506.203125,482,7710,9341,17533
FASTAI_34,NeuralNetFastAI_r34,0.46875,511.20703125,482,7710,9340,17532
FASTAI_35,NeuralNetFastAI_r35,0.3125,507.2578125,481,7710,9339,17530
FASTAI_36,NeuralNetFastAI_r36,0.46875,504.984375,477,7710,9336,17523
FASTAI_37,NeuralNetFastAI_r37,0.15625,509.12890625,483,7710,9342,17535
FASTAI_38,NeuralNetFastAI_r38,0.3125,505.46484375,476,7710,9334,17520
FASTAI_39,NeuralNetFastAI_r39,0.3125,524.41796875,482,7710,9341,17533
FASTAI_40,NeuralNetFastAI_r40,0.3125,506.71875,481,7710,9339,17530
FASTAI_41,NeuralNetFastAI_r41,0.3125,506.1484375,480,7710,9339,17529
FASTAI_42,NeuralNetFastAI_r42,0.46875,509.56640625,483,7710,9342,17535
FASTAI_43,NeuralNetFastAI_r43,0.3125,509.62890625,483,7710,9342,17535
FASTAI_44,NeuralNetFastAI_r44,0.3125,514.48828125,481,7710,9340,17531
FASTAI_45,NeuralNetFastAI_r45,0.3125,507.109375,477,7710,9336,17523
FASTAI_46,NeuralNetFastAI_r46,0.15625,514.984375,481,7710,9340,17531
FASTAI_47,NeuralNetFastAI_r47,0.15625,509.65234375,480,7710,9339,17529
FASTAI_48,NeuralNetFastAI_r48,0.15625,508.53125,478,7710,9337,17525
FASTAI_49,NeuralNetFastAI_r49,0.46875,509.5625,483,7710,9342,17535
FASTAI_50,NeuralNetFastAI_r50,0.46875,507.20703125,477,7710,9336,17523
FASTAI_51,NeuralNetFastAI_r51,0.46875,506.2421875,482,7710,9341,17533
FASTAI_52,NeuralNetFastAI_r52,0.15625,507.24609375,477,7710,9335,17522
FASTAI_53,NeuralNetFastAI_r53,0.46875,519.18359375,482,7710,9341,17533
FASTAI_54,NeuralNetFastAI_r54,0.3125,508.94140625,481,7710,9340,17531
FASTAI_55,NeuralNetFastAI_r55,0.3125,519.37109375,482,7710,9341,17533
FASTAI_56,NeuralNetFastAI_r56,0.46875,506.984375,477,7710,9336,17523
FASTAI_57,NeuralNetFastAI_r57,0.15625,507.5859375,477,7710,9335,17522
FASTAI_58,NeuralNetFastAI_r58,0.3125,506.57421875,482,7710,9341,17533
FASTAI_59,NeuralNetFastAI_r59,0.3125,509.21875,483,7710,9342,17535
FASTAI_60,NeuralNetFastAI_r60,0.15625,507.41015625,477,7710,9335,17522
FASTAI_61,NeuralNetFastAI_r61,0.46875,505.390625,476,7710,9334,17520
FASTAI_62,NeuralNetFastAI_r62,0.3125,509.5625,483,7710,9342,17535
FASTAI_63,NeuralNetFastAI_r63,0.3125,506.375,480,7710,9339,17529
FASTAI_64,NeuralNetFastAI_r64,0.3125,509.44140625,483,7710,9342,17535
FASTAI_65,NeuralNetFastAI_r65,0.46875,506.0078125,478,7710,9337,17525
FASTAI_66,NeuralNetFastAI_r66,0.3125,506.1015625,478,7710,9337,17525
FASTAI_67,NeuralNetFastAI_r67,0.46875,509.79296875,483,7710,9342,17535
FASTAI_68,NeuralNetFastAI_r68,0.46875,505.78515625,480,7710,9339,17529
FASTAI_69,NeuralNetFastAI_r69,0.3125,506.60546875,481,7710,9339,17530
FASTAI_70,NeuralNetFastAI_r70,0.3125,508.37890625,481,7710,9340,17531
FASTAI_71,NeuralNetFastAI_r71,0.3125,515.73828125,483,7710,9342,17535
FASTAI_72,NeuralNetFastAI_r72,0.3125,505.046875,477,7710,9336,17523
FASTAI_73,NeuralNetFastAI_r73,0.3125,505.296875,477,7710,9336,17523
FASTAI_74,NeuralNetFastAI_r74,0.3125,508.76953125,481,7710,9340,17531
FASTAI_75,NeuralNetFastAI_r75,0.46875,506.36328125,478,7710,9337,17525
FASTAI_76,NeuralNetFastAI_r76,0.15625,507.27734375,477,7710,9335,17522
FASTAI_77,NeuralNetFastAI_r77,0.15625,506.109375,480,7710,9339,17529
FASTAI_78,NeuralNetFastAI_r78,0.3125,509.48828125,483,7710,9342,17535
FASTAI_79,NeuralNetFastAI_r79,0.3125,508.578125,481,7710,9340,17531
FASTAI_80,NeuralNetFastAI_r80,0.3125,507.05078125,479,7710,9337,17526
FASTAI_81,NeuralNetFastAI_r81,0.625,506.56640625,482,7710,9341,17533
FASTAI_82,NeuralNetFastAI_r82,0.3125,506.55859375,480,7710,9339,17529
FASTAI_83,NeuralNetFastAI_r83,0.15625,509.609375,482,7710,9341,17533
FASTAI_84,NeuralNetFastAI_r84,0.3125,509.8203125,482,7710,9341,17533
FASTAI_85,NeuralNetFastAI_r85,0.3125,508.5078125,481,7710,9340,17531
FASTAI_86,NeuralNetFastAI_r86,0.3125,518.74609375,482,7710,9341,17533
FASTAI_87,NeuralNetFastAI_r87,0.3125,507.50390625,481,7710,9339,17530
FASTAI_88,NeuralNetFastAI_r88,0.3125,505.02734375,478,7710,9337,17525
FASTAI_89,NeuralNetFastAI_r89,0.3125,510.4609375,482,7710,9341,17533
FASTAI_90,NeuralNetFastAI_r90,0.3125,509.5234375,483,7710,9342,17535
FASTAI_91,NeuralNetFastAI_r91,0.15625,506.25390625,480,7710,9339,17529
FASTAI_92,NeuralNetFastAI_r92,0.46875,505.87109375,478,7710,9337,17525
FASTAI_93,NeuralNetFastAI_r93,0.46875,506.7578125,480,7710,9339,17529
FASTAI_94,NeuralNetFastAI_r94,0.46875,506.48828125,482,7710,9341,17533
FASTAI_95,NeuralNetFastAI_r95,0.3125,512.25390625,482,7710,9340,17532
FASTAI_96,NeuralNetFastAI_r96,0.46875,509.83984375,483,7710,9342,17535
FASTAI_97,NeuralNetFastAI_r97,0.46875,509.41796875,480,7710,9339,17529
FASTAI_98,NeuralNetFastAI_r98,0.3125,505.21484375,477,7710,9336,17523
FASTAI_99,NeuralNetFastAI_r99,0.46875,508.2578125,481,7710,9340,17531
FASTAI_100,NeuralNetFastAI_r100,0.46875,518.4375,483,7710,9345,17538
FASTAI_101,NeuralNetFastAI_r101,0.3125,519.32421875,483,7710,9345,17538
FASTAI_102,NeuralNetFastAI_r102,0.3125,505.7734375,481,7710,9343,17534
FASTAI_103,NeuralNetFastAI_r103,0.15625,514.84375,482,7710,9344,17536
FASTAI_104,NeuralNetFastAI_r104,0.46875,506.4296875,481,7710,9343,17534
FASTAI_105,NeuralNetFastAI_r105,0.3125,508.4453125,482,7710,9344,17536
FASTAI_106,NeuralNetFastAI_r106,0.3125,514.7421875,482,7710,9344,17536
FASTAI_107,NeuralNetFastAI_r107,0.3125,519.34375,483,7710,9345,17538
FASTAI_108,NeuralNetFastAI_r108,0.3125,511.6328125,483,7710,9344,17537
FASTAI_109,NeuralNetFastAI_r109,0.3125,512.16015625,483,7710,9344,17537
FASTAI_110,NeuralNetFastAI_r110,0.15625,516.12890625,483,7710,9345,17538
FASTAI_111,NeuralNetFastAI_r111,0.3125,508.78515625,482,7710,9344,17536
FASTAI_112,NeuralNetFastAI_r112,0.3125,506.18359375,479,7710,9341,17530
FASTAI_113,NeuralNetFastAI_r113,0.3125,505.30078125,477,7710,9338,17525
FASTAI_114,NeuralNetFastAI_r114,0.3125,505.015625,478,7710,9340,17528
FASTAI_115,NeuralNetFastAI_r115,0.3125,505.5625,481,7710,9343,17534
FASTAI_116,NeuralNetFastAI_r116,0.46875,506.71484375,483,7710,9345,17538
FASTAI_117,NeuralNetFastAI_r117,0.3125,518.9140625,483,7710,9345,17538
FASTAI_118,NeuralNetFastAI_r118,0.3125,508.03515625,482,7710,9344,17536
FASTAI_119,NeuralNetFastAI_r119,0.46875,509.3984375,484,7710,9346,17540
FASTAI_120,NeuralNetFastAI_r120,0.3125,512.20703125,483,7710,9344,17537
FASTAI_121,NeuralNetFastAI_r121,0.15625,508.44140625,482,7710,9344,17536
FASTAI_122,NeuralNetFastAI_r122,0.46875,508.4921875,482,7710,9344,17536
FASTAI_123,NeuralNetFastAI_r123,0.3125,509.125,482,7710,9344,17536
FASTAI_124,NeuralNetFastAI_r124,0.3125,507.69921875,482,7710,9344,17536
FASTAI_125,NeuralNetFastAI_r125,0.625,506.9375,483,7710,9345,17538
FASTAI_126,NeuralNetFastAI_r126,8.47265625,525.6796875,483,7710,9345,17538
FASTAI_127,NeuralNetFastAI_r127,0.46875,506.6796875,481,7710,9343,17534
FASTAI_128,NeuralNetFastAI_r128,0.3125,506.80078125,480,7710,9341,17531
FASTAI_129,NeuralNetFastAI_r129,0.15625,509.9453125,483,7710,9345,17538
FASTAI_130,NeuralNetFastAI_r130,0.3125,509.9453125,481,7710,9343,17534
FASTAI_131,NeuralNetFastAI_r131,0.3125,510.96484375,481,7710,9342,17533
FASTAI_132,NeuralNetFastAI_r132,0.15625,506.5625,481,7710,9343,17534
FASTAI_133,NeuralNetFastAI_r133,0.46875,510.15625,483,7710,9345,17538
FASTAI_134,NeuralNetFastAI_r134,0.46875,519.203125,483,7710,9345,17538
FASTAI_135,NeuralNetFastAI_r135,0.15625,509.90625,481,7710,9343,17534
FASTAI_136,NeuralNetFastAI_r136,0.15625,515.25390625,482,7710,9344,17536
FASTAI_137,NeuralNetFastAI_r137,0.3125,507.11328125,480,7710,9341,17531
FASTAI_138,NeuralNetFastAI_r138,0.3125,521.203125,482,7710,9343,17535
FASTAI_139,NeuralNetFastAI_r139,0.46875,509.328125,484,7710,9346,17540
FASTAI_140,NeuralNetFastAI_r140,0.3125,512.2578125,483,7710,9344,17537
FASTAI_141,NeuralNetFastAI_r141,0.46875,508.84375,482,7710,9344,17536
FASTAI_142,NeuralNetFastAI_r142,0.3125,509.39453125,484,7710,9346,17540
FASTAI_143,NeuralNetFastAI_r143,0.46875,506.6875,483,7710,9345,17538
FASTAI_144,NeuralNetFastAI_r144,0.3125,517.8046875,483,7710,9345,17538
FASTAI_145,NeuralNetFastAI_r145,0.625,512.51953125,483,7710,9344,17537
FASTAI_146,NeuralNetFastAI_r146,0.3125,519.48828125,483,7710,9345,17538
FASTAI_147,NeuralNetFastAI_r147,0.3125,505.3515625,477,7710,9338,17525
FASTAI_148,NeuralNetFastAI_r148,0.625,509.046875,482,7710,9344,17536
FASTAI_149,NeuralNetFastAI_r149,0.15625,506.19140625,481,7710,9343,17534
FASTAI_150,NeuralNetFastAI_r150,0.625,508.66796875,482,7710,9344,17536
FASTAI_151,NeuralNetFastAI_r151,0.46875,509.23828125,479,7710,9341,17530
FASTAI_152,NeuralNetFastAI_r152,0.15625,517.765625,483,7710,9345,17538
FASTAI_153,NeuralNetFastAI_r153,0.46875,519.1171875,483,7710,9345,17538
FASTAI_154,NeuralNetFastAI_r154,0.46875,514.6953125,482,7710,9344,17536
FASTAI_155,NeuralNetFastAI_r155,0.3125,509.95703125,481,7710,9343,17534
FASTAI_156,NeuralNetFastAI_r156,0.3125,506.15625,479,7710,9341,17530
FASTAI_157,NeuralNetFastAI_r157,0.3125,519.14453125,483,7710,9345,17538
FASTAI_158,NeuralNetFastAI_r158,0.3125,509.90234375,484,7710,9346,17540
FASTAI_159,NeuralNetFastAI_r159,0.3125,505.6796875,477,7710,9338,17525
FASTAI_160,NeuralNetFastAI_r160,0.15625,511.76953125,483,7710,9344,17537
FASTAI_161,NeuralNetFastAI_r161,0.3125,506.90625,483,7710,9345,17538
FASTAI_162,NeuralNetFastAI_r162,0.46875,508.7578125,482,7710,9344,17536
FASTAI_163,NeuralNetFastAI_r163,0.46875,509.56640625,484,7710,9346,17540
FASTAI_164,NeuralNetFastAI_r164,0.46875,509.46484375,482,7710,9344,17536
FASTAI_165,NeuralNetFastAI_r165,0.3125,510.0625,483,7710,9345,17538
FASTAI_166,NeuralNetFastAI_r166,0.3125,507.62109375,478,7710,9339,17527
FASTAI_167,NeuralNetFastAI_r167,0.46875,519.05859375,483,7710,9345,17538
FASTAI_168,NeuralNetFastAI_r168,0.15625,509.73828125,484,7710,9346,17540
FASTAI_169,NeuralNetFastAI_r169,0.46875,509.9296875,484,7710,9346,17540
FASTAI_170,NeuralNetFastAI_r170,0.3125,524.0234375,483,7710,9345,17538
FASTAI_171,NeuralNetFastAI_r171,0.3125,525.51171875,483,7710,9345,17538
FASTAI_172,NeuralNetFastAI_r172,0.3125,505.7421875,479,7710,9341,17530
FASTAI_173,NeuralNetFastAI_r173,0.3125,507.27734375,482,7710,9343,17535
FASTAI_174,NeuralNetFastAI_r174,0.3125,510.2265625,479,7710,9341,17530
FASTAI_175,NeuralNetFastAI_r175,0.3125,519.29296875,483,7710,9345,17538
FASTAI_176,NeuralNetFastAI_r176,0.46875,508.703125,482,7710,9344,17536
FASTAI_177,NeuralNetFastAI_r177,0.3125,514.2890625,482,7710,9344,17536
FASTAI_178,NeuralNetFastAI_r178,0.46875,506.7421875,481,7710,9343,17534
FASTAI_179,NeuralNetFastAI_r179,0.15625,505.2578125,478,7710,9340,17528
FASTAI_180,NeuralNetFastAI_r180,0.46875,510.5859375,481,7710,9342,17533
FASTAI_181,NeuralNetFastAI_r181,0.3125,507.78515625,478,7710,9339,17527
FASTAI_182,NeuralNetFastAI_r182,0.3125,506.46484375,481,7710,9343,17534
FASTAI_183,NeuralNetFastAI_r183,0.46875,506.58984375,483,7710,9345,17538
FASTAI_184,NeuralNetFastAI_r184,0.46875,506.578125,483,7710,9345,17538
FASTAI_185,NeuralNetFastAI_r185,0.3125,509.37109375,483,7710,9345,17538
FASTAI_186,NeuralNetFastAI_r186,0.3125,507.23046875,480,7710,9341,17531
FASTAI_187,NeuralNetFastAI_r187,0.3125,506.40625,483,7710,9345,17538
FASTAI_188,NeuralNetFastAI_r188,0.3125,514.5390625,482,7710,9344,17536
FASTAI_189,NeuralNetFastAI_r189,0.15625,505.2734375,478,7710,9340,17528
FASTAI_190,NeuralNetFastAI_r190,0.3125,519.08984375,483,7710,9345,17538
FASTAI_191,NeuralNetFastAI_r191,0.3125,519.54296875,483,7710,9345,17538
FASTAI_192,NeuralNetFastAI_r192,0.3125,508.36328125,482,7710,9344,17536
FASTAI_193,NeuralNetFastAI_r193,0.3125,506.734375,480,7710,9341,17531
FASTAI_194,NeuralNetFastAI_r194,0.46875,516.90234375,484,7710,9346,17540
FASTAI_195,NeuralNetFastAI_r195,0.46875,507.6171875,478,7710,9339,17527
FASTAI_196,NeuralNetFastAI_r196,0.46875,508.90234375,482,7710,9344,17536
FASTAI_197,NeuralNetFastAI_r197,0.46875,515.1328125,482,7710,9344,17536
FASTAI_198,NeuralNetFastAI_r198,0.15625,509.79296875,481,7710,9343,17534
FASTAI_199,NeuralNetFastAI_r199,0.15625,517.87890625,483,7710,9345,17538
FASTAI_200,NeuralNetFastAI_r200,0.3125,512.203125,483,7710,9344,17537
CAT_0,CatBoost_c1,0.46875,175.46484375,391,7710,343786,351887
CAT_1,CatBoost_r1,0.46875,183.21484375,520,7710,61921,70151
CAT_2,CatBoost_r2,0.46875,173.12890625,520,7710,47977,56207
CAT_3,CatBoost_r3,0.46875,185.94140625,524,7710,80102,88336
CAT_4,CatBoost_r4,0.46875,173.28515625,520,7722,111170,119412
CAT_5,CatBoost_r5,0.625,171.09765625,524,7710,134286,142520
CAT_6,CatBoost_r6,0.46875,174.37890625,520,7710,231090,239320
CAT_7,CatBoost_r7,0.78125,181.87890625,524,7722,369022,377268
CAT_8,CatBoost_r8,0.625,172.03515625,524,7710,109574,117808
CAT_9,CatBoost_r9,0.15625,183.12890625,520,7710,61897,70127
CAT_10,CatBoost_r10,0.46875,179.53515625,521,7710,441015,449246
CAT_11,CatBoost_r11,0.46875,171.91015625,525,7710,99442,107677
CAT_12,CatBoost_r12,0.3125,179.56640625,525,7722,282362,290609
CAT_13,CatBoost_r13,0.3125,185.97265625,525,7710,165770,174005
CAT_14,CatBoost_r14,0.15625,188.31640625,521,7710,765463,773694
CAT_15,CatBoost_r15,0.3125,183.94140625,521,7710,575935,584166
CAT_16,CatBoost_r16,0.625,175.34765625,525,7710,292810,301045
CAT_17,CatBoost_r17,0.3125,174.72265625,521,7710,167350,175581
CAT_18,CatBoost_r18,0.625,178.31640625,525,7722,99426,107673
CAT_19,CatBoost_r19,0.46875,179.56640625,525,7710,436178,444413
CAT_20,CatBoost_r20,0.3125,171.59765625,525,7710,55169,63404
CAT_21,CatBoost_r21,0.46875,177.8671875,525,7722,447411,455658
CAT_22,CatBoost_r22,0.625,171.7734375,525,7710,74578,82813
CAT_23,CatBoost_r23,0.78125,172.2421875,525,7710,68857,77092
CAT_24,CatBoost_r24,0.15625,175.9921875,521,7722,56253,64496
CAT_25,CatBoost_r25,0.46875,170.9921875,525,7710,60081,68316
CAT_26,CatBoost_r26,0.625,172.2421875,525,7722,76642,84889
CAT_27,CatBoost_r27,0.46875,182.0859375,525,7710,591610,599845
CAT_28,CatBoost_r28,0.15625,182.3984375,521,7710,65093,73324
CAT_29,CatBoost_r29,0.46875,171.4609375,525,7710,72514,80749
CAT_30,CatBoost_r30,0.46875,171.6171875,525,7722,55089,63336
CAT_31,CatBoost_r31,0.46875,186.48046875,525,7710,153226,161461
CAT_32,CatBoost_r32,0.625,187.88671875,525,7722,226362,234609
CAT_33,CatBoost_r33,0.625,177.88671875,525,7710,93130,101365
CAT_34,CatBoost_r34,0.625,175.38671875,525,7710,336507,344742
CAT_35,CatBoost_r35,0.3125,186.48046875,521,7710,140030,148261
CAT_36,CatBoost_r36,0.3125,172.41796875,521,7710,47325,55556
CAT_37,CatBoost_r37,0.3125,173.35546875,525,7722,140618,148865
CAT_38,CatBoost_r38,0.625,173.51171875,525,7710,65129,73364
CAT_39,CatBoost_r39,0.78125,178.51171875,525,7722,106410,114657
CAT_40,CatBoost_r40,0.3125,171.16796875,521,7710,51509,59740
CAT_41,CatBoost_r41,0.46875,171.02734375,525,7722,51345,59592
CAT_42,CatBoost_r42,0.46875,176.18359375,525,7710,215690,223925
CAT_43,CatBoost_r43,0.3125,186.49609375,521,7722,111294,119537
CAT_44,CatBoost_r44,0.15625,175.24609375,521,7710,53757,61988
CAT_45,CatBoost_r45,0.46875,172.12109375,525,7722,49553,57800
CAT_46,CatBoost_r46,0.15625,172.43359375,521,7710,47469,55700
CAT_47,CatBoost_r47,0.15625,179.62109375,521,7722,90070,98313
CAT_48,CatBoost_r48,0.46875,170.55859375,525,7710,49993,58228
CAT_49,CatBoost_r49,0.46875,171.96484375,525,7710,80970,89205
CAT_50,CatBoost_r50,0.3125,172.90234375,521,7722,184726,192969
CAT_51,CatBoost_r51,0.625,172.140625,521,7710,90390,98621
CAT_52,CatBoost_r52,0.3125,185.578125,525,7722,54409,62656
CAT_53,CatBoost_r53,0.78125,172.609375,521,7710,88598,96829
CAT_54,CatBoost_r54,0.3125,184.796875,521,7710,57597,65828
CAT_55,CatBoost_r55,0.46875,180.578125,521,7710,114910,123141
CAT_56,CatBoost_r56,0.3125,180.109375,521,7710,313230,321461
CAT_57,CatBoost_r57,0.46875,180.578125,521,7710,305630,313861
CAT_58,CatBoost_r58,0.625,178.703125,525,7710,159650,167885
CAT_59,CatBoost_r59,0.3125,171.515625,521,7710,68205,76436
CAT_60,CatBoost_r60,0.46875,172.453125,525,7722,53065,61312
CAT_61,CatBoost_r61,0.46875,173.87109375,525,7710,49585,57820
CAT_62,CatBoost_r62,0.625,189.80859375,525,7722,427762,436009
CAT_63,CatBoost_r63,0.3125,172.62109375,521,7710,48237,56468
CAT_64,CatBoost_r64,0.3125,179.49609375,525,7710,262434,270669
CAT_65,CatBoost_r65,0.3125,171.37109375,521,7722,59829,68072
CAT_66,CatBoost_r66,0.15625,180.12109375,521,7710,251990,260221
CAT_67,CatBoost_r67,0.3125,187.15234375,521,7710,741407,749638
CAT_68,CatBoost_r68,0.46875,172.15234375,525,7710,72986,81221
CAT_69,CatBoost_r69,0.3125,171.99609375,525,7710,157338,165573
CAT_70,CatBoost_r70,0.3125,176.05859375,521,7722,65957,74200
CAT_71,CatBoost_r71,0.46875,181.8671875,521,7710,170046,178277
CAT_72,CatBoost_r72,0.46875,171.3984375,525,7710,55137,63372
CAT_73,CatBoost_r73,0.15625,175.9296875,521,7710,177230,185461
CAT_74,CatBoost_r74,0.3125,179.3671875,521,7722,48845,57088
CAT_75,CatBoost_r75,0.625,183.5859375,521,7710,224630,232861
CAT_76,CatBoost_r76,0.46875,190.7734375,525,7710,779178,787413
CAT_77,CatBoost_r77,0.3125,171.7109375,525,7710,53929,62164
CAT_78,CatBoost_r78,0.46875,173.7421875,525,7722,50673,58920
CAT_79,CatBoost_r79,0.3125,172.0234375,525,7722,55105,63352
CAT_80,CatBoost_r80,0.46875,185.6171875,525,7710,973931,982166
CAT_81,CatBoost_r81,0.46875,199.328125,521,7710,822790,831021
CAT_82,CatBoost_r82,0.625,171.421875,525,7710,55177,63412
CAT_83,CatBoost_r83,0.625,175.328125,525,7722,289522,297769
CAT_84,CatBoost_r84,0.3125,175.484375,525,7710,188250,196485
CAT_85,CatBoost_r85,0.3125,178.609375,525,7710,112930,121165
CAT_86,CatBoost_r86,0.625,188.140625,525,7722,290466,298713
CAT_87,CatBoost_r87,0.625,179.546875,521,7710,200886,209117
CAT_88,CatBoost_r88,0.15625,179.078125,521,7710,58509,66740
CAT_89,CatBoost_r89,0.625,171.578125,525,7710,55249,63484
CAT_90,CatBoost_r90,0.15625,179.390625,521,7710,62813,71044
CAT_91,CatBoost_r91,0.3125,173.78515625,525,7710,49593,57828
CAT_92,CatBoost_r92,0.3125,179.56640625,521,7722,89374,97617
CAT_93,CatBoost_r93,0.3125,173.00390625,521,7710,61597,69828
CAT_94,CatBoost_r94,0.15625,172.84765625,521,7710,53741,61972
CAT_95,CatBoost_r95,0.46875,174.56640625,521,7722,234086,242329
CAT_96,CatBoost_r96,0.3125,173.78515625,525,7710,68897,77132
CAT_97,CatBoost_r97,0.3125,178.47265625,525,7710,614211,622446
CAT_98,CatBoost_r98,0.46875,172.22265625,525,7710,78290,86525
CAT_99,CatBoost_r99,0.46875,172.06640625,525,7722,55129,63376
CAT_100,CatBoost_r100,0.3125,172.84765625,522,7722,48473,56717
CAT_101,CatBoost_r101,0.46875,180.2109375,522,7710,49113,57345
CAT_102,CatBoost_r102,0.625,171.82421875,526,7710,55309,63545
CAT_103,CatBoost_r103,0.3125,183.0234375,526,7710,663135,671371
CAT_104,CatBoost_r104,0.15625,176.3046875,522,7722,50689,58933
CAT_105,CatBoost_r105,0.625,190.6796875,526,7710,800382,808618
CAT_106,CatBoost_r106,0.3125,193.8046875,526,7710,1181159,1189395
CAT_107,CatBoost_r107,0.78125,188.0234375,526,7710,222062,230298
CAT_108,CatBoost_r108,0.3125,188.3359375,522,7710,184098,192330
CAT_109,CatBoost_r109,0.46875,171.9296875,526,7710,55093,63329
CAT_110,CatBoost_r110,3.4375,210.359375,526,7722,3000943,3009191
CAT_111,CatBoost_r111,0.3125,185.71875,526,7710,71373,79609
CAT_112,CatBoost_r112,0.625,178.84375,526,7710,131646,139882
CAT_113,CatBoost_r113,0.625,174.78125,526,7722,90310,98558
CAT_114,CatBoost_r114,0.625,174.3125,526,7710,265623,273859
CAT_115,CatBoost_r115,0.15625,186.96875,522,7722,57801,66045
CAT_116,CatBoost_r116,0.46875,173.6875,526,7710,49461,57697
CAT_117,CatBoost_r117,0.625,174.0,522,7722,142690,150934
CAT_118,CatBoost_r118,0.15625,187.90625,522,7710,139330,147562
CAT_119,CatBoost_r119,2.34375,200.796875,526,7710,2100039,2108275
CAT_120,CatBoost_r120,0.46875,173.53125,526,7710,49341,57577
CAT_121,CatBoost_r121,0.46875,172.30078125,526,7710,194319,202555
CAT_122,CatBoost_r122,0.15625,174.64453125,522,7710,152266,160498
CAT_123,CatBoost_r123,0.15625,203.55078125,522,7722,971298,979542
CAT_124,CatBoost_r124,0.46875,185.58203125,526,7710,97102,105338
CAT_125,CatBoost_r125,0.46875,191.20703125,522,7710,569154,577386
CAT_126,CatBoost_r126,0.3125,171.05078125,526,7710,50373,58609
CAT_127,CatBoost_r127,0.46875,186.05078125,526,7710,75798,84034
CAT_128,CatBoost_r128,0.625,199.64453125,522,7722,822914,831158
CAT_129,CatBoost_r129,0.46875,171.83203125,522,7710,71497,79729
CAT_130,CatBoost_r130,0.3125,173.23828125,522,7710,95826,104058
CAT_131,CatBoost_r131,0.15625,179.046875,522,7722,102682,110926
CAT_132,CatBoost_r132,0.3125,173.1015625,522,7710,64449,72681
CAT_133,CatBoost_r133,0.46875,178.2578125,526,7710,97606,105842
CAT_134,CatBoost_r134,0.46875,186.3828125,522,7722,192282,200526
CAT_135,CatBoost_r135,0.625,179.5078125,526,7710,159790,168026
CAT_136,CatBoost_r136,0.625,173.1015625,526,7722,220703,228951
CAT_137,CatBoost_r137,0.78125,172.7890625,526,7710,104006,112242
CAT_138,CatBoost_r138,0.3125,171.8515625,526,7710,55141,63377
CAT_139,CatBoost_r139,0.46875,172.4765625,526,7722,242023,250271
CAT_140,CatBoost_r140,0.15625,180.6015625,522,7710,73898,82130
CAT_141,CatBoost_r141,0.625,171.71875,526,7710,169047,177283
CAT_142,CatBoost_r142,0.15625,179.21875,522,7710,225778,234010
CAT_143,CatBoost_r143,0.46875,178.59375,526,7710,101542,109778
CAT_144,CatBoost_r144,0.15625,186.71875,522,7722,71241,79485
CAT_145,CatBoost_r145,0.3125,179.53125,522,7710,49273,57505
CAT_146,CatBoost_r146,0.625,188.90625,526,7710,290278,298514
CAT_147,CatBoost_r147,0.625,185.78125,526,7710,88822,97058
CAT_148,CatBoost_r148,0.3125,179.203125,526,7722,233646,241894
CAT_149,CatBoost_r149,0.46875,178.59375,526,7710,109998,118234
CAT_150,CatBoost_r150,0.15625,176.875,522,7710,65977,74209
CAT_151,CatBoost_r151,0.46875,179.23828125,526,7722,176710,184958
CAT_152,CatBoost_r152,0.15625,179.70703125,522,7710,62977,71209
CAT_153,CatBoost_r153,0.46875,186.58203125,522,7710,57817,66049
CAT_154,CatBoost_r154,0.15625,183.14453125,522,7710,412994,421226
CAT_155,CatBoost_r155,0.625,178.92578125,526,7710,139734,147970
CAT_156,CatBoost_r156,0.15625,176.73828125,522,7722,53409,61653
CAT_157,CatBoost_r157,0.3125,180.64453125,522,7710,333362,341594
CAT_158,CatBoost_r158,0.15625,175.95703125,522,7710,259298,267530
CAT_159,CatBoost_r159,0.15625,178.92578125,522,7710,79578,87810
CAT_160,CatBoost_r160,0.3125,171.58203125,522,7710,73554,81786
CAT_161,CatBoost_r161,0.3125,176.58984375,522,7722,86370,94614
CAT_162,CatBoost_r162,0.3125,179.24609375,522,7710,86194,94426
CAT_163,CatBoost_r163,0.625,174.875,526,7710,322767,331003
CAT_164,CatBoost_r164,0.46875,171.59375,526,7710,49133,57369
CAT_165,CatBoost_r165,0.3125,184.875,522,7722,57761,66005
CAT_166,CatBoost_r166,0.46875,173.625,526,7710,50093,58329
CAT_167,CatBoost_r167,0.46875,178.9375,526,7722,131062,139310
CAT_168,CatBoost_r168,0.46875,184.40625,522,7710,72866,81098
CAT_169,CatBoost_r169,0.3125,173.46875,526,7710,51685,59921
CAT_170,CatBoost_r170,0.46875,185.96875,526,7710,54733,62969
CAT_171,CatBoost_r171,0.3125,170.671875,526,7710,54741,62977
CAT_172,CatBoost_r172,0.15625,185.984375,522,7722,494498,502742
CAT_173,CatBoost_r173,0.46875,178.484375,526,7710,80318,88554
CAT_174,CatBoost_r174,0.3125,172.546875,522,7710,65945,74177
CAT_175,CatBoost_r175,0.15625,175.984375,522,7722,60145,68389
CAT_176,CatBoost_r176,0.15625,172.546875,522,7710,47425,55657
CAT_177,CatBoost_r177,0.3125,173.796875,526,7710,54525,62761
CAT_178,CatBoost_r178,0.46875,178.796875,526,7722,101758,110006
CAT_179,CatBoost_r179,0.625,174.109375,526,7710,68453,76689
CAT_180,CatBoost_r180,0.15625,180.671875,522,7722,91922,100166
CAT_181,CatBoost_r181,0.3125,179.1328125,522,7710,65929,74161
CAT_182,CatBoost_r182,0.3125,174.6015625,526,7710,68661,76897
CAT_183,CatBoost_r183,0.625,172.5703125,526,7710,209214,217450
CAT_184,CatBoost_r184,0.3125,177.5703125,522,7710,338995,347227
CAT_185,CatBoost_r185,0.3125,186.1640625,526,7722,71517,79765
CAT_186,CatBoost_r186,0.15625,181.0078125,522,7710,323146,331378
CAT_187,CatBoost_r187,0.3125,171.7890625,522,7710,73626,81858
CAT_188,CatBoost_r188,0.3125,179.9140625,526,7710,188886,197122
CAT_189,CatBoost_r189,0.3125,172.7265625,522,7722,47345,55589
CAT_190,CatBoost_r190,0.46875,186.6328125,526,7710,153102,161338
CAT_191,CatBoost_r191,0.46875,179.1484375,526,7710,137710,145946
CAT_192,CatBoost_r192,0.3125,178.3671875,526,7722,126534,134782
CAT_193,CatBoost_r193,0.625,171.1796875,526,7710,121022,129258
CAT_194,CatBoost_r194,0.46875,179.7734375,522,7722,58609,66853
CAT_195,CatBoost_r195,0.3125,188.3671875,522,7710,790635,798867
CAT_196,CatBoost_r196,0.3125,172.1171875,522,7710,48017,56249
CAT_197,CatBoost_r197,0.46875,172.5859375,526,7710,104718,112954
CAT_198,CatBoost_r198,0.46875,177.2734375,526,7722,411687,419935
CAT_199,CatBoost_r199,0.3125,171.6484375,526,7710,65429,73665
CAT_200,CatBoost_r200,0.3125,180.0859375,522,7722,303298,311542
