Model_ID,Model,Inference_Memory_Usage,Peak_Memory_During_Inference,Predictor_Size,Learner_Size,Models_Size,Total_Size
XT_0,ExtraTrees_c1,10371072,6368133,387,7710,5584679,5592776
XT_1,ExtraTrees_r1,1441792,1736997,456,7710,807912,816078
XT_2,ExtraTrees_r2,2097152,2544735,454,7710,1681104,1689268
XT_3,ExtraTrees_r3,2756608,3070161,454,7710,2306625,2314789
XT_4,ExtraTrees_r4,1331200,1528403,456,7722,435350,443528
XT_5,ExtraTrees_r5,4247552,4386780,454,7710,3598138,3606302
XT_6,ExtraTrees_r6,1310720,1586877,454,7710,666714,674878
XT_7,ExtraTrees_r7,917504,949246,454,7722,149210,157386
XT_8,ExtraTrees_r8,2359296,2544793,454,7710,1681104,1689268
XT_9,ExtraTrees_r9,1310720,1586877,454,7710,666714,674878
XT_10,ExtraTrees_r10,786432,950748,455,7722,149214,157391
XT_11,ExtraTrees_r11,2228224,2546237,455,7710,1681108,1689273
XT_12,ExtraTrees_r12,1069056,1186672,457,7710,249332,257499
XT_13,ExtraTrees_r13,6029312,6369631,455,7722,5584803,5592980
XT_14,ExtraTrees_r14,786432,1167530,457,7710,243074,251241
XT_15,ExtraTrees_r15,3014656,3264051,457,7722,2475836,2484015
XT_16,ExtraTrees_r16,4194304,4392610,457,7710,3621218,3629385
XT_17,ExtraTrees_r17,1310720,1738383,457,7710,807916,816083
XT_18,ExtraTrees_r18,4063232,4388230,455,7722,3598166,3606343
XT_19,ExtraTrees_r19,5767168,3859037,457,7710,3064995,3073162
XT_20,ExtraTrees_r20,2228224,2546121,455,7710,1681108,1689273
XT_21,ExtraTrees_r21,3014656,3264109,457,7722,2475836,2484015
XT_22,ExtraTrees_r22,2490368,2526375,457,7710,1561775,1569942
XT_23,ExtraTrees_r23,-16502784,1512528,457,7710,425860,434027
XT_24,ExtraTrees_r24,2367488,2527657,457,7722,1573159,1581338
XT_25,ExtraTrees_r25,2097152,2526375,457,7710,1561775,1569942
XT_26,ExtraTrees_r26,-110592,2336335,455,7722,1318047,1326224
XT_27,ExtraTrees_r27,917504,1186788,457,7710,249332,257499
XT_28,ExtraTrees_r28,2752512,2546253,455,7722,1681132,1689309
XT_29,ExtraTrees_r29,1179648,1588263,455,7710,666718,674883
XT_30,ExtraTrees_r30,2228224,2336319,455,7710,1318023,1326188
XT_31,ExtraTrees_r31,2359296,2686302,457,7722,1899915,1908094
XT_32,ExtraTrees_r32,4980736,5174362,457,7710,4381788,4389955
XT_33,ExtraTrees_r33,3031040,3071663,455,7710,2306629,2314794
XT_34,ExtraTrees_r34,1069056,1186804,457,7722,249356,257535
XT_35,ExtraTrees_r35,3014656,3264151,457,7710,2475812,2483979
XT_36,ExtraTrees_r36,2359296,2732444,457,7722,1946164,1954343
XT_37,ExtraTrees_r37,2359296,2686368,457,7710,1899891,1908058
XT_38,ExtraTrees_r38,3014656,3196319,457,7722,2415187,2423366
XT_39,ExtraTrees_r39,3686400,4005900,457,7710,3215102,3223269
XT_40,ExtraTrees_r40,1179648,1529773,457,7710,435330,443497
XT_41,ExtraTrees_r41,3145728,3264167,457,7722,2475836,2484015
XT_42,ExtraTrees_r42,4517888,4682764,457,7710,3898552,3906719
XT_43,ExtraTrees_r43,2383872,2546195,455,7722,1681132,1689309
XT_44,ExtraTrees_r44,786432,1007910,457,7710,167306,175473
XT_45,ExtraTrees_r45,2752512,3071605,455,7710,2306629,2314794
XT_46,ExtraTrees_r46,3166208,3264109,457,7722,2475836,2484015
XT_47,ExtraTrees_r47,655360,1022094,457,7710,171946,180113
XT_48,ExtraTrees_r48,3276800,3264109,457,7722,2475836,2484015
XT_49,ExtraTrees_r49,5898240,6369633,455,7710,5584779,5592944
XT_50,ExtraTrees_r50,1179648,1529773,457,7710,435330,443497
XT_51,ExtraTrees_r51,655360,950806,455,7722,149214,157391
XT_52,ExtraTrees_r52,1462272,1588263,455,7710,666718,674883
XT_53,ExtraTrees_r53,1310720,1387698,455,7710,361456,369621
XT_54,ExtraTrees_r54,806912,1022052,457,7722,171970,180149
XT_55,ExtraTrees_r55,1048576,1387640,455,7710,361456,369621
XT_56,ExtraTrees_r56,2752512,3071605,455,7710,2306629,2314794
XT_57,ExtraTrees_r57,1310720,1387714,455,7722,361480,369657
XT_58,ExtraTrees_r58,937984,950732,455,7710,149190,157355
XT_59,ExtraTrees_r59,2752512,3071605,455,7710,2306629,2314794
XT_60,ExtraTrees_r60,1179648,1512486,457,7722,425884,434063
XT_61,ExtraTrees_r61,1724416,1725009,457,7710,789827,797994
XT_62,ExtraTrees_r62,806912,1022052,457,7722,171970,180149
XT_63,ExtraTrees_r63,1462272,1529773,457,7710,435330,443497
XT_64,ExtraTrees_r64,786432,1022110,457,7722,171970,180149
XT_65,ExtraTrees_r65,917504,1167646,457,7710,243074,251241
XT_66,ExtraTrees_r66,2228224,2526433,457,7710,1561775,1569942
XT_67,ExtraTrees_r67,1048576,1186804,457,7722,249356,257535
XT_68,ExtraTrees_r68,1048576,1083197,455,7710,212419,220584
XT_69,ExtraTrees_r69,3276800,3264109,457,7722,2475836,2484015
XT_70,ExtraTrees_r70,1179648,1205973,457,7710,255895,264062
XT_71,ExtraTrees_r71,2883584,3071679,455,7722,2306653,2314830
XT_72,ExtraTrees_r72,1630208,1588321,455,7710,666718,674883
XT_73,ExtraTrees_r73,2363392,2336393,455,7722,1318047,1326224
XT_74,ExtraTrees_r74,1572864,1588263,455,7710,666718,674883
XT_75,ExtraTrees_r75,806912,950790,455,7710,149190,157355
XT_76,ExtraTrees_r76,2519040,2546195,455,7722,1681132,1689309
XT_77,ExtraTrees_r77,1048576,950790,455,7710,149190,157355
XT_78,ExtraTrees_r78,4251648,4392626,457,7722,3621242,3629421
XT_79,ExtraTrees_r79,786432,1083255,455,7710,212419,220584
XT_80,ExtraTrees_r80,3014656,3196377,457,7722,2415187,2423366
XT_81,ExtraTrees_r81,4460544,4388280,455,7710,3598142,3606307
XT_82,ExtraTrees_r82,2883584,3196369,457,7710,2415163,2423330
XT_83,ExtraTrees_r83,1441792,1741451,457,7722,807940,816119
XT_84,ExtraTrees_r84,1179648,1676124,457,7710,766467,774634
XT_85,ExtraTrees_r85,3670016,4005842,457,7710,3215102,3223269
XT_86,ExtraTrees_r86,2637824,2686418,457,7722,1899915,1908094
XT_87,ExtraTrees_r87,1331200,1588205,455,7710,666718,674883
XT_88,ExtraTrees_r88,2621440,3071621,455,7722,2306653,2314830
XT_89,ExtraTrees_r89,3932160,4388222,455,7710,3598142,3606307
XT_90,ExtraTrees_r90,1331200,1387698,455,7710,361456,369621
XT_91,ExtraTrees_r91,2248704,2336277,455,7722,1318047,1326224
XT_92,ExtraTrees_r92,2228224,2546179,455,7710,1681108,1689273
XT_93,ExtraTrees_r93,786432,1186730,457,7710,249332,257499
XT_94,ExtraTrees_r94,917504,950748,455,7722,149214,157391
XT_95,ExtraTrees_r95,2359296,2548211,457,7710,1526246,1534413
XT_96,ExtraTrees_r96,2228224,2336277,455,7722,1318047,1326224
XT_97,ExtraTrees_r97,1449984,1387698,455,7710,361456,369621
XT_98,ExtraTrees_r98,3014656,3196369,457,7710,2415163,2423330
XT_99,ExtraTrees_r99,2490368,2709489,457,7710,1925660,1933827
XT_100,ExtraTrees_r100,1310720,1588283,456,7722,666746,674924
XT_101,ExtraTrees_r101,1187840,1588325,456,7710,666722,674888
XT_102,ExtraTrees_r102,655360,1186808,458,7722,249360,257540
XT_103,ExtraTrees_r103,2097152,2527593,458,7710,1573139,1581307
XT_104,ExtraTrees_r104,2228224,2546125,456,7710,1681112,1689278
XT_105,ExtraTrees_r105,2883584,3264171,458,7722,2475840,2484020
XT_106,ExtraTrees_r106,917504,1167650,458,7710,243078,251246
XT_107,ExtraTrees_r107,786432,1206307,458,7722,255923,264103
XT_108,ExtraTrees_r108,1310720,1588209,456,7710,666722,674888
XT_109,ExtraTrees_r109,9568256,6369625,456,7710,5584783,5592949
XT_110,ExtraTrees_r110,2551808,2686364,458,7722,1899919,1908099
XT_111,ExtraTrees_r111,1593344,1487907,458,7710,411449,419617
XT_112,ExtraTrees_r112,9568256,6369575,456,7722,5584807,5592985
XT_113,ExtraTrees_r113,786432,950794,456,7710,149194,157360
XT_114,ExtraTrees_r114,3932160,4005852,458,7722,3215130,3223310
XT_115,ExtraTrees_r115,2883584,3196313,458,7710,2415167,2423335
XT_116,ExtraTrees_r116,917504,1205919,458,7710,255899,264067
XT_117,ExtraTrees_r117,2752512,2336381,456,7710,1318027,1326193
XT_118,ExtraTrees_r118,1179648,1206249,458,7722,255923,264103
XT_119,ExtraTrees_r119,4063232,4388290,456,7722,3598170,3606348
XT_120,ExtraTrees_r120,4063232,4388282,456,7710,3598146,3606312
XT_121,ExtraTrees_r121,917504,1186792,458,7710,249336,257504
XT_122,ExtraTrees_r122,-12288000,1512548,458,7722,425888,434068
XT_123,ExtraTrees_r123,1179648,1387644,456,7710,361460,369626
XT_124,ExtraTrees_r124,1052672,950752,456,7722,149218,157396
XT_125,ExtraTrees_r125,2097152,2527651,458,7710,1573139,1581307
XT_126,ExtraTrees_r126,4063232,4388282,456,7710,3598146,3606312
XT_127,ExtraTrees_r127,2363392,2527601,458,7722,1573163,1581343
XT_128,ExtraTrees_r128,917504,950678,456,7710,149194,157360
XT_129,ExtraTrees_r129,1966080,2526477,458,7722,1561803,1569983
XT_130,ExtraTrees_r130,2359296,2546183,456,7710,1681112,1689278
XT_131,ExtraTrees_r131,3031040,3264113,458,7722,2475840,2484020
XT_132,ExtraTrees_r132,2621440,3071667,456,7710,2306633,2314799
XT_133,ExtraTrees_r133,2097152,2336381,456,7710,1318027,1326193
XT_134,ExtraTrees_r134,4980736,5174454,458,7722,4381816,4389996
XT_135,ExtraTrees_r135,2097152,2336323,456,7710,1318027,1326193
XT_136,ExtraTrees_r136,1052672,1022114,458,7722,171974,180154
XT_137,ExtraTrees_r137,2228224,2527593,458,7710,1573139,1581307
XT_138,ExtraTrees_r138,917504,1007972,458,7710,167310,175478
XT_139,ExtraTrees_r139,1597440,1725145,458,7722,789855,798035
XT_140,ExtraTrees_r140,798720,950752,456,7722,149218,157396
XT_141,ExtraTrees_r141,2543616,2709491,458,7710,1925664,1933832
XT_142,ExtraTrees_r142,2228224,2709375,458,7710,1925664,1933832
XT_143,ExtraTrees_r143,2379776,2546257,456,7722,1681136,1689314
XT_144,ExtraTrees_r144,4325376,4392614,458,7710,3621222,3629390
XT_145,ExtraTrees_r145,1441792,1387718,456,7722,361484,369662
XT_146,ExtraTrees_r146,2228224,2546241,456,7710,1681112,1689278
XT_147,ExtraTrees_r147,1179648,1167534,458,7710,243078,251246
XT_148,ExtraTrees_r148,6311936,6369633,456,7722,5584807,5592985
XT_149,ExtraTrees_r149,3952640,4005902,458,7710,3215106,3223274
XT_150,ExtraTrees_r150,3076096,3196313,458,7710,2415167,2423335
XT_151,ExtraTrees_r151,4456448,4388232,456,7722,3598170,3606348
XT_152,ExtraTrees_r152,2228224,2526319,458,7710,1561779,1569947
XT_153,ExtraTrees_r153,2359296,2336397,456,7722,1318051,1326229
XT_154,ExtraTrees_r154,1966080,2336381,456,7710,1318027,1326193
XT_155,ExtraTrees_r155,1048576,1083265,456,7722,212447,220625
XT_156,ExtraTrees_r156,1196032,1167592,458,7710,243078,251246
XT_157,ExtraTrees_r157,3145728,3295480,458,7710,2515345,2523513
XT_158,ExtraTrees_r158,4911104,5174454,458,7722,4381816,4389996
XT_159,ExtraTrees_r159,1458176,1205977,458,7710,255899,264067
XT_160,ExtraTrees_r160,1310720,1588225,456,7722,666746,674924
XT_161,ExtraTrees_r161,970752,1186734,458,7710,249336,257504
XT_162,ExtraTrees_r162,3014656,3196371,458,7710,2415167,2423335
XT_163,ExtraTrees_r163,1581056,1676144,458,7722,766495,774675
XT_164,ExtraTrees_r164,2379776,2526435,458,7710,1561779,1569947
XT_165,ExtraTrees_r165,3407872,3295496,458,7722,2515369,2523549
XT_166,ExtraTrees_r166,6029312,6369625,456,7710,5584783,5592949
XT_167,ExtraTrees_r167,3014656,3071609,456,7710,2306633,2314799
XT_168,ExtraTrees_r168,6164480,6369625,456,7710,5584783,5592949
XT_169,ExtraTrees_r169,655360,1007930,458,7722,167334,175514
XT_170,ExtraTrees_r170,1331200,1588209,456,7710,666722,674888
XT_171,ExtraTrees_r171,2506752,2546241,456,7710,1681112,1689278
XT_172,ExtraTrees_r172,2359296,2709441,458,7722,1925688,1933868
XT_173,ExtraTrees_r173,1331200,1387586,456,7710,361460,369626
XT_174,ExtraTrees_r174,1179648,1529793,458,7722,435358,443538
XT_175,ExtraTrees_r175,1441792,1676128,458,7710,766471,774639
XT_176,ExtraTrees_r176,2228224,2526435,458,7710,1561779,1569947
XT_177,ExtraTrees_r177,3801088,4005910,458,7722,3215130,3223310
XT_178,ExtraTrees_r178,2359296,2732490,458,7710,1946144,1954312
XT_179,ExtraTrees_r179,1441792,1676186,458,7710,766471,774639
XT_180,ExtraTrees_r180,655360,1083265,456,7722,212447,220625
XT_181,ExtraTrees_r181,1372160,1387644,456,7710,361460,369626
XT_182,ExtraTrees_r182,1310720,1588325,456,7710,666722,674888
XT_183,ExtraTrees_r183,2490368,2732564,458,7722,1946168,1954348
XT_184,ExtraTrees_r184,2752512,2686314,458,7710,1899895,1908063
XT_185,ExtraTrees_r185,2228224,2548289,458,7722,1526274,1534454
XT_186,ExtraTrees_r186,786432,950794,456,7710,149194,157360
XT_187,ExtraTrees_r187,786432,1022114,458,7722,171974,180154
XT_188,ExtraTrees_r188,1187840,1205977,458,7710,255899,264067
XT_189,ExtraTrees_r189,3145728,3071609,456,7710,2306633,2314799
XT_190,ExtraTrees_r190,974848,1083207,456,7722,212447,220625
XT_191,ExtraTrees_r191,3686400,4005902,458,7710,3215106,3223274
XT_192,ExtraTrees_r192,1310720,1387718,456,7722,361484,369662
XT_193,ExtraTrees_r193,2490368,2546241,456,7710,1681112,1689278
XT_194,ExtraTrees_r194,2752512,3196371,458,7710,2415167,2423335
XT_195,ExtraTrees_r195,4587520,4682726,458,7722,3898580,3906760
XT_196,ExtraTrees_r196,2752512,3196371,458,7710,2415167,2423335
XT_197,ExtraTrees_r197,4218880,4392688,458,7722,3621246,3629426
XT_198,ExtraTrees_r198,2494464,2527593,458,7710,1573139,1581307
XT_199,ExtraTrees_r199,2883584,3071667,456,7710,2306633,2314799
XT_200,ExtraTrees_r200,1183744,1186808,458,7722,249360,257540
XGB_0,XGBoost_c1,131072,140624,391,7710,8693,16794
XGB_1,XGBoost_c2,131072,140656,417,7710,8722,16849
XGB_2,XGBoost_c3,266240,126840,414,7722,8227,16363
XGB_3,XGBoost_c4,266240,127525,439,7722,8256,16417
XGB_4,XGBoost_r1,131072,141010,509,7722,8877,17108
XGB_5,XGBoost_r2,131072,140999,509,7710,8853,17072
XGB_6,XGBoost_r3,131072,141016,509,7722,8877,17108
XGB_7,XGBoost_r4,131072,141011,509,7722,8877,17108
XGB_8,XGBoost_r5,131072,127187,509,7710,8334,16553
XGB_9,XGBoost_r6,135168,140936,509,7722,8877,17108
XGB_10,XGBoost_r7,131072,140831,509,7710,8853,17072
XGB_11,XGBoost_r8,131072,141071,509,7722,8877,17108
XGB_12,XGBoost_r9,266240,127872,509,7722,8358,16589
XGB_13,XGBoost_r10,131072,140882,510,7710,8857,17077
XGB_14,XGBoost_r11,131072,141071,510,7722,8881,17113
XGB_15,XGBoost_r12,131072,126841,510,7722,8362,16594
XGB_16,XGBoost_r13,131072,140827,510,7722,8881,17113
XGB_17,XGBoost_r14,131072,140822,510,7710,8857,17077
XGB_18,XGBoost_r15,131072,140773,510,7722,8881,17113
XGB_19,XGBoost_r16,131072,140831,510,7722,8881,17113
XGB_20,XGBoost_r17,135168,141007,510,7710,8857,17077
XGB_21,XGBoost_r18,131072,140885,510,7722,8881,17113
XGB_22,XGBoost_r19,135168,140839,510,7722,8881,17113
XGB_23,XGBoost_r20,131072,140932,510,7710,8857,17077
XGB_24,XGBoost_r21,397312,140886,510,7722,8881,17113
XGB_25,XGBoost_r22,131072,140888,510,7722,8881,17113
XGB_26,XGBoost_r23,131072,141061,510,7710,8857,17077
XGB_27,XGBoost_r24,262144,128054,510,7722,8362,16594
XGB_28,XGBoost_r25,131072,127368,510,7722,8362,16594
XGB_29,XGBoost_r26,131072,127653,510,7710,8338,16558
XGB_30,XGBoost_r27,303104,127595,510,7722,8362,16594
XGB_31,XGBoost_r28,266240,128285,510,7722,8362,16594
XGB_32,XGBoost_r29,131072,140942,510,7710,8857,17077
XGB_33,XGBoost_r30,131072,141011,510,7722,8881,17113
XGB_34,XGBoost_r31,131072,140959,510,7722,8881,17113
XGB_35,XGBoost_r32,131072,140996,510,7710,8857,17077
XGB_36,XGBoost_r33,131072,140837,510,7722,8881,17113
XGB_37,XGBoost_r34,131072,140889,510,7722,8881,17113
XGB_38,XGBoost_r35,131072,140939,510,7710,8857,17077
XGB_39,XGBoost_r36,397312,128056,510,7722,8362,16594
XGB_40,XGBoost_r37,266240,127597,510,7722,8362,16594
XGB_41,XGBoost_r38,270336,140834,510,7710,8857,17077
XGB_42,XGBoost_r39,131072,141073,510,7722,8881,17113
XGB_43,XGBoost_r40,262144,141010,510,7722,8881,17113
XGB_44,XGBoost_r41,131072,141063,510,7710,8857,17077
XGB_45,XGBoost_r42,262144,140900,510,7722,8881,17113
XGB_46,XGBoost_r43,311296,140953,510,7722,8881,17113
XGB_47,XGBoost_r44,266240,127427,510,7710,8338,16558
XGB_48,XGBoost_r45,266240,140886,510,7722,8881,17113
XGB_49,XGBoost_r46,131072,127767,510,7722,8362,16594
XGB_50,XGBoost_r47,135168,140884,510,7710,8857,17077
XGB_51,XGBoost_r48,131072,140877,510,7722,8881,17113
XGB_52,XGBoost_r49,131072,141020,510,7722,8881,17113
XGB_53,XGBoost_r50,131072,140824,510,7710,8857,17077
XGB_54,XGBoost_r51,266240,128115,510,7722,8362,16594
XGB_55,XGBoost_r52,131072,127597,510,7722,8362,16594
XGB_56,XGBoost_r53,266240,126851,510,7710,8338,16558
XGB_57,XGBoost_r54,131072,140946,510,7722,8881,17113
XGB_58,XGBoost_r55,131072,127881,510,7722,8362,16594
XGB_59,XGBoost_r56,266240,140834,510,7710,8857,17077
XGB_60,XGBoost_r57,131072,127536,510,7722,8362,16594
XGB_61,XGBoost_r58,266240,127468,510,7722,8362,16594
XGB_62,XGBoost_r59,131072,127830,510,7710,8338,16558
XGB_63,XGBoost_r60,323584,141067,510,7722,8881,17113
XGB_64,XGBoost_r61,131072,141011,510,7722,8881,17113
XGB_65,XGBoost_r62,266240,126900,510,7710,8338,16558
XGB_66,XGBoost_r63,262144,140889,510,7722,8881,17113
XGB_67,XGBoost_r64,131072,127531,510,7722,8362,16594
XGB_68,XGBoost_r65,262144,140821,510,7710,8857,17077
XGB_69,XGBoost_r66,131072,140705,510,7722,8881,17113
XGB_70,XGBoost_r67,401408,140944,510,7710,8857,17077
XGB_71,XGBoost_r68,266240,127181,510,7722,8362,16594
XGB_72,XGBoost_r69,131072,140950,510,7722,8881,17113
XGB_73,XGBoost_r70,131072,141002,510,7710,8857,17077
XGB_74,XGBoost_r71,266240,127828,510,7722,8362,16594
XGB_75,XGBoost_r72,131072,140954,510,7722,8881,17113
XGB_76,XGBoost_r73,266240,127601,510,7722,8362,16594
XGB_77,XGBoost_r74,131072,140938,510,7710,8857,17077
XGB_78,XGBoost_r75,131072,140956,510,7722,8881,17113
XGB_79,XGBoost_r76,131072,141016,510,7722,8881,17113
XGB_80,XGBoost_r77,131072,140878,510,7710,8857,17077
XGB_81,XGBoost_r78,135168,127065,510,7722,8362,16594
XGB_82,XGBoost_r79,131072,141071,510,7722,8881,17113
XGB_83,XGBoost_r80,131072,127246,510,7710,8338,16558
XGB_84,XGBoost_r81,131072,140950,510,7722,8881,17113
XGB_85,XGBoost_r82,135168,140889,510,7722,8881,17113
XGB_86,XGBoost_r83,131072,127895,510,7710,8338,16558
XGB_87,XGBoost_r84,131072,140882,510,7722,8881,17113
XGB_88,XGBoost_r85,131072,141003,510,7722,8881,17113
XGB_89,XGBoost_r86,397312,127378,510,7710,8338,16558
XGB_90,XGBoost_r87,266240,127832,510,7722,8362,16594
XGB_91,XGBoost_r88,131072,140948,510,7722,8881,17113
XGB_92,XGBoost_r89,303104,140992,510,7710,8857,17077
XGB_93,XGBoost_r90,131072,140884,510,7722,8881,17113
XGB_94,XGBoost_r91,266240,126894,510,7722,8362,16594
XGB_95,XGBoost_r92,131072,127546,510,7710,8338,16558
XGB_96,XGBoost_r93,135168,127078,510,7722,8362,16594
XGB_97,XGBoost_r94,131072,141015,510,7722,8881,17113
XGB_98,XGBoost_r95,266240,140762,510,7710,8857,17077
XGB_99,XGBoost_r96,131072,141071,510,7722,8881,17113
XGB_100,XGBoost_r97,266240,127595,510,7722,8362,16594
XGB_101,XGBoost_r98,266240,127719,510,7710,8338,16558
XGB_102,XGBoost_r99,135168,127300,510,7722,8362,16594
XGB_103,XGBoost_r100,131072,140957,511,7722,8885,17118
XGB_104,XGBoost_r101,270336,127028,511,7710,8342,16563
XGB_105,XGBoost_r102,286720,127821,511,7722,8366,16599
XGB_106,XGBoost_r103,131072,140955,511,7722,8885,17118
XGB_107,XGBoost_r104,266240,127612,511,7710,8342,16563
XGB_108,XGBoost_r105,131072,140893,511,7722,8885,17118
XGB_109,XGBoost_r106,266240,127725,511,7722,8366,16599
XGB_110,XGBoost_r107,131072,140821,511,7710,8861,17082
XGB_111,XGBoost_r108,131072,140820,511,7722,8885,17118
XGB_112,XGBoost_r109,131072,127542,511,7722,8366,16599
XGB_113,XGBoost_r110,131072,140882,511,7710,8861,17082
XGB_114,XGBoost_r111,266240,127424,511,7722,8366,16599
XGB_115,XGBoost_r112,266240,127484,511,7722,8366,16599
XGB_116,XGBoost_r113,131072,128012,511,7710,8342,16563
XGB_117,XGBoost_r114,266240,126729,511,7722,8366,16599
XGB_118,XGBoost_r115,266240,127662,511,7722,8366,16599
XGB_119,XGBoost_r116,131072,140830,511,7710,8861,17082
XGB_120,XGBoost_r117,184320,140900,511,7722,8885,17118
XGB_121,XGBoost_r118,266240,126898,511,7722,8366,16599
XGB_122,XGBoost_r119,188416,127369,511,7722,8366,16599
XGB_123,XGBoost_r120,131072,127780,511,7710,8342,16563
XGB_124,XGBoost_r121,266240,127589,511,7722,8366,16599
XGB_125,XGBoost_r122,131072,127996,511,7722,8366,16599
XGB_126,XGBoost_r123,266240,128246,511,7710,8342,16563
XGB_127,XGBoost_r124,278528,140893,511,7722,8885,17118
XGB_128,XGBoost_r125,266240,141065,511,7710,8861,17082
XGB_129,XGBoost_r126,135168,140893,511,7722,8885,17118
XGB_130,XGBoost_r127,266240,127196,511,7722,8366,16599
XGB_131,XGBoost_r128,266240,140814,511,7710,8861,17082
XGB_132,XGBoost_r129,131072,127302,511,7722,8366,16599
XGB_133,XGBoost_r130,131072,141073,511,7722,8885,17118
XGB_134,XGBoost_r131,131072,127208,511,7710,8342,16563
XGB_135,XGBoost_r132,266240,140896,511,7722,8885,17118
XGB_136,XGBoost_r133,266240,127590,511,7722,8366,16599
XGB_137,XGBoost_r134,262144,140819,511,7710,8861,17082
XGB_138,XGBoost_r135,266240,140823,511,7722,8885,17118
XGB_139,XGBoost_r136,131072,127949,511,7722,8366,16599
XGB_140,XGBoost_r137,266240,140946,511,7710,8861,17082
XGB_141,XGBoost_r138,266240,140841,511,7722,8885,17118
XGB_142,XGBoost_r139,131072,128352,511,7722,8366,16599
XGB_143,XGBoost_r140,266240,141005,511,7710,8861,17082
XGB_144,XGBoost_r141,131072,140780,511,7722,8885,17118
XGB_145,XGBoost_r142,131072,126968,511,7722,8366,16599
XGB_146,XGBoost_r143,135168,128248,511,7710,8342,16563
XGB_147,XGBoost_r144,131072,140875,511,7722,8885,17118
XGB_148,XGBoost_r145,266240,127543,511,7722,8366,16599
XGB_149,XGBoost_r146,266240,127783,511,7710,8342,16563
XGB_150,XGBoost_r147,131072,140954,511,7722,8885,17118
XGB_151,XGBoost_r148,131072,141078,511,7722,8885,17118
XGB_152,XGBoost_r149,405504,141004,511,7710,8861,17082
XGB_153,XGBoost_r150,266240,126554,511,7722,8366,16599
XGB_154,XGBoost_r151,131072,140952,511,7722,8885,17118
XGB_155,XGBoost_r152,266240,127776,511,7710,8342,16563
XGB_156,XGBoost_r153,266240,141009,511,7722,8885,17118
XGB_157,XGBoost_r154,131072,141073,511,7722,8885,17118
XGB_158,XGBoost_r155,135168,140954,511,7710,8861,17082
XGB_159,XGBoost_r156,266240,141068,511,7722,8885,17118
XGB_160,XGBoost_r157,266240,127377,511,7722,8366,16599
XGB_161,XGBoost_r158,131072,140762,511,7710,8861,17082
XGB_162,XGBoost_r159,139264,127026,511,7722,8366,16599
XGB_163,XGBoost_r160,270336,140954,511,7722,8885,17118
XGB_164,XGBoost_r161,274432,141002,511,7710,8861,17082
XGB_165,XGBoost_r162,266240,128184,511,7722,8366,16599
XGB_166,XGBoost_r163,131072,140889,511,7722,8885,17118
XGB_167,XGBoost_r164,131072,127782,511,7710,8342,16563
XGB_168,XGBoost_r165,131072,140706,511,7722,8885,17118
XGB_169,XGBoost_r166,131072,141012,511,7722,8885,17118
XGB_170,XGBoost_r167,131072,141065,511,7710,8861,17082
XGB_171,XGBoost_r168,167936,127708,511,7722,8366,16599
XGB_172,XGBoost_r169,131072,126904,511,7722,8366,16599
XGB_173,XGBoost_r170,131072,141007,511,7710,8861,17082
XGB_174,XGBoost_r171,131072,127304,511,7722,8366,16599
XGB_175,XGBoost_r172,131072,141009,511,7722,8885,17118
XGB_176,XGBoost_r173,262144,140952,511,7710,8861,17082
XGB_177,XGBoost_r174,335872,127374,511,7722,8366,16599
XGB_178,XGBoost_r175,131072,141011,511,7722,8885,17118
XGB_179,XGBoost_r176,262144,140824,511,7710,8861,17082
XGB_180,XGBoost_r177,135168,140787,511,7722,8885,17118
XGB_181,XGBoost_r178,131072,140892,511,7722,8885,17118
XGB_182,XGBoost_r179,131072,140890,511,7710,8861,17082
XGB_183,XGBoost_r180,131072,140846,511,7722,8885,17118
XGB_184,XGBoost_r181,266240,126959,511,7722,8366,16599
XGB_185,XGBoost_r182,266240,127141,511,7722,8366,16599
XGB_186,XGBoost_r183,131072,127144,511,7710,8342,16563
XGB_187,XGBoost_r184,131072,140947,511,7722,8885,17118
XGB_188,XGBoost_r185,188416,141010,511,7722,8885,17118
XGB_189,XGBoost_r186,315392,127967,511,7710,8342,16563
XGB_190,XGBoost_r187,266240,140951,511,7722,8885,17118
XGB_191,XGBoost_r188,131072,126910,511,7722,8366,16599
XGB_192,XGBoost_r189,131072,140947,511,7710,8861,17082
XGB_193,XGBoost_r190,131072,127667,511,7722,8366,16599
XGB_194,XGBoost_r191,262144,141067,511,7722,8885,17118
XGB_195,XGBoost_r192,131072,126569,511,7710,8342,16563
XGB_196,XGBoost_r193,131072,128125,511,7722,8366,16599
XGB_197,XGBoost_r194,131072,127367,511,7722,8366,16599
XGB_198,XGBoost_r195,131072,140814,511,7710,8861,17082
XGB_199,XGBoost_r196,131072,127253,511,7722,8366,16599
XGB_200,XGBoost_r197,131072,140899,511,7722,8885,17118
XGB_201,XGBoost_r198,131072,127432,511,7710,8342,16563
XGB_202,XGBoost_r199,131072,127821,511,7722,8366,16599
XGB_203,XGBoost_r200,131072,140942,511,7722,8885,17118
TABPFN_0,TabPFN_c1,3256320,104254387,394,7710,103388970,103397074
TABPFN_1,TabPFN_c2,138072064,104255072,425,7710,103389007,103397142
TABPFN_2,TabPFN_c3,181141504,104254559,425,7710,103389007,103397142
RF_0,RandomForest_c1,3538944,3808611,390,7710,3045669,3053769
RF_1,RandomForest_r1,1724416,1751874,456,7710,831917,840083
RF_2,RandomForest_r2,2490368,2603300,454,7710,1813296,1821460
RF_3,RandomForest_r3,3018752,2940580,454,7722,2156236,2164412
RF_4,RandomForest_r4,1593344,1569031,456,7710,456354,464520
RF_5,RandomForest_r5,3145728,3373465,454,7722,2597410,2605586
RF_6,RandomForest_r6,1441792,1761747,454,7710,838281,846445
RF_7,RandomForest_r7,786432,1019912,454,7710,172231,180395
RF_8,RandomForest_r8,2752512,2603308,454,7722,1813320,1821496
RF_9,RandomForest_r9,1724416,1761747,454,7710,838281,846445
RF_10,RandomForest_r10,786432,1019800,455,7710,172235,180400
RF_11,RandomForest_r11,2490368,2603302,455,7710,1813300,1821465
RF_12,RandomForest_r12,1200128,1241319,457,7722,267604,275783
RF_13,RandomForest_r13,3731456,3809283,455,7710,3045764,3053929
RF_14,RandomForest_r14,1110016,1243459,457,7722,268404,276583
RF_15,RandomForest_r15,2490368,2621958,457,7710,1852056,1860223
RF_16,RandomForest_r16,2883584,3075162,457,7722,2298854,2307033
RF_17,RandomForest_r17,1576960,1751994,457,7710,831921,840088
RF_18,RandomForest_r18,3014656,3373511,455,7710,2597390,2605555
RF_19,RandomForest_r19,2772992,2845882,457,7710,2063603,2071770
RF_20,RandomForest_r20,2228224,2603252,455,7722,1813324,1821501
RF_21,RandomForest_r21,2621440,2621958,457,7710,1852056,1860223
RF_22,RandomForest_r22,2363392,2448784,457,7722,1419546,1427725
RF_23,RandomForest_r23,-11776000,1568004,457,7710,456521,464688
RF_24,RandomForest_r24,2097152,2431054,457,7710,1395833,1404000
RF_25,RandomForest_r25,2490368,2448784,457,7722,1419546,1427725
RF_26,RandomForest_r26,3018752,2524206,455,7710,1544624,1552789
RF_27,RandomForest_r27,1048576,1241319,457,7722,267604,275783
RF_28,RandomForest_r28,2359296,2603302,455,7710,1813300,1821465
RF_29,RandomForest_r29,1572864,1761693,455,7710,838285,846450
RF_30,RandomForest_r30,2359296,2524214,455,7722,1544648,1552825
RF_31,RandomForest_r31,2359296,2528987,457,7710,1681798,1689965
RF_32,RandomForest_r32,3276800,3372458,457,7710,2590546,2598713
RF_33,RandomForest_r33,2621440,2940584,455,7722,2156240,2164417
RF_34,RandomForest_r34,1069056,1241245,457,7710,267580,275747
RF_35,RandomForest_r35,2228224,2621966,457,7722,1852080,1860259
RF_36,RandomForest_r36,2228224,2526890,457,7710,1620660,1628827
RF_37,RandomForest_r37,2097152,2528937,457,7722,1681822,1690001
RF_38,RandomForest_r38,2359296,2596095,457,7710,1798767,1806934
RF_39,RandomForest_r39,2621440,2906183,457,7710,2136892,2145059
RF_40,RandomForest_r40,1441792,1568993,457,7722,456382,464561
RF_41,RandomForest_r41,2228224,2621958,457,7710,1852056,1860223
RF_42,RandomForest_r42,2883584,3198261,457,7722,2395343,2403522
RF_43,RandomForest_r43,2621440,2603244,455,7710,1813300,1821465
RF_44,RandomForest_r44,786432,1029210,457,7710,174351,182518
RF_45,RandomForest_r45,2883584,2940642,455,7722,2156240,2164417
RF_46,RandomForest_r46,2228224,2621958,457,7710,1852056,1860223
RF_47,RandomForest_r47,917504,1029226,457,7722,174375,182554
RF_48,RandomForest_r48,2752512,2622016,457,7710,1852056,1860223
RF_49,RandomForest_r49,3670016,3809241,455,7722,3045788,3053965
RF_50,RandomForest_r50,1441792,1569035,457,7710,456358,464525
RF_51,RandomForest_r51,937984,1019858,455,7710,172235,180400
RF_52,RandomForest_r52,1720320,1761693,455,7710,838285,846450
RF_53,RandomForest_r53,1441792,1546559,455,7722,456394,464571
RF_54,RandomForest_r54,933888,1029210,457,7710,174351,182518
RF_55,RandomForest_r55,1581056,1546601,455,7710,456370,464535
RF_56,RandomForest_r56,2752512,2940642,455,7722,2156240,2164417
RF_57,RandomForest_r57,1441792,1546543,455,7710,456370,464535
RF_58,RandomForest_r58,970752,1019932,455,7722,172259,180436
RF_59,RandomForest_r59,2752512,2940626,455,7710,2156216,2164381
RF_60,RandomForest_r60,1331200,1568004,457,7710,456521,464688
RF_61,RandomForest_r61,1703936,1750049,457,7722,832105,840284
RF_62,RandomForest_r62,1048576,1029210,457,7710,174351,182518
RF_63,RandomForest_r63,1048576,1569035,457,7710,456358,464525
RF_64,RandomForest_r64,786432,1029168,457,7722,174375,182554
RF_65,RandomForest_r65,1048576,1243327,457,7710,268380,276547
RF_66,RandomForest_r66,2101248,2448784,457,7722,1419546,1427725
RF_67,RandomForest_r67,1048576,1241303,457,7710,267580,275747
RF_68,RandomForest_r68,1331200,1234177,455,7710,266264,274429
RF_69,RandomForest_r69,-270336,2622024,457,7722,1852080,1860259
RF_70,RandomForest_r70,1052672,1242131,457,7722,267924,276103
RF_71,RandomForest_r71,2752512,2940626,455,7710,2156216,2164381
RF_72,RandomForest_r72,1441792,1761751,455,7710,838285,846450
RF_73,RandomForest_r73,2490368,2524214,455,7722,1544648,1552825
RF_74,RandomForest_r74,1703936,1761751,455,7710,838285,846450
RF_75,RandomForest_r75,790528,1019874,455,7722,172259,180436
RF_76,RandomForest_r76,2228224,2603302,455,7710,1813300,1821465
RF_77,RandomForest_r77,1048576,1019916,455,7710,172235,180400
RF_78,RandomForest_r78,2752512,3075220,457,7722,2298854,2307033
RF_79,RandomForest_r79,1048576,1234293,455,7710,266264,274429
RF_80,RandomForest_r80,2359296,2596111,457,7722,1798791,1806970
RF_81,RandomForest_r81,3538944,3373511,455,7710,2597390,2605555
RF_82,RandomForest_r82,2359296,2596095,457,7710,1798767,1806934
RF_83,RandomForest_r83,1703936,1752010,457,7722,831945,840124
RF_84,RandomForest_r84,1593344,1762354,457,7710,835921,844088
RF_85,RandomForest_r85,2490368,2906315,457,7722,2136916,2145095
RF_86,RandomForest_r86,2359296,2528929,457,7710,1681798,1689965
RF_87,RandomForest_r87,1835008,1761693,455,7710,838285,846450
RF_88,RandomForest_r88,3014656,2940584,455,7722,2156240,2164417
RF_89,RandomForest_r89,3280896,3373511,455,7710,2597390,2605555
RF_90,RandomForest_r90,1310720,1546601,455,7710,456370,464535
RF_91,RandomForest_r91,2379776,2524214,455,7722,1544648,1552825
RF_92,RandomForest_r92,2752512,2603186,455,7710,1813300,1821465
RF_93,RandomForest_r93,1179648,1241303,457,7710,267580,275747
RF_94,RandomForest_r94,1048576,1019874,455,7722,172259,180436
RF_95,RandomForest_r95,2359296,2508392,457,7710,1471202,1479369
RF_96,RandomForest_r96,2359296,2524156,455,7722,1544648,1552825
RF_97,RandomForest_r97,1314816,1546543,455,7710,456370,464535
RF_98,RandomForest_r98,2228224,2596095,457,7710,1798767,1806934
RF_99,RandomForest_r99,2228224,2497181,457,7710,1580180,1588347
RF_100,RandomForest_r100,1572864,1761713,456,7722,838313,846491
RF_101,RandomForest_r101,1441792,1761755,456,7710,838289,846455
RF_102,RandomForest_r102,1179648,1241323,458,7722,267608,275788
RF_103,RandomForest_r103,2228224,2431058,458,7710,1395837,1404005
RF_104,RandomForest_r104,2228224,2603304,456,7710,1813304,1821470
RF_105,RandomForest_r105,2228224,2622026,458,7722,1852084,1860264
RF_106,RandomForest_r106,1060864,1243447,458,7710,268384,276552
RF_107,RandomForest_r107,917504,1242177,458,7710,267904,276072
RF_108,RandomForest_r108,1589248,1761713,456,7722,838313,846491
RF_109,RandomForest_r109,3407872,3809287,456,7710,3045768,3053934
RF_110,RandomForest_r110,2097152,2528997,458,7722,1681826,1690006
RF_111,RandomForest_r111,1310720,1566591,458,7710,455562,463730
RF_112,RandomForest_r112,3670016,3809303,456,7722,3045792,3053970
RF_113,RandomForest_r113,933888,1019920,456,7710,172239,180405
RF_114,RandomForest_r114,2621440,2906319,458,7722,2136920,2145100
RF_115,RandomForest_r115,2490368,2596099,458,7710,1798771,1806939
RF_116,RandomForest_r116,1069056,1242119,458,7710,267904,276072
RF_117,RandomForest_r117,3014656,2524208,456,7710,1544628,1552794
RF_118,RandomForest_r118,1179648,1242193,458,7722,267928,276108
RF_119,RandomForest_r119,3284992,3373399,456,7710,2597394,2605560
RF_120,RandomForest_r120,2752512,3373531,456,7722,2597418,2605596
RF_121,RandomForest_r121,917504,1241307,458,7710,267584,275752
RF_122,RandomForest_r122,-3678208,1568024,458,7722,456549,464729
RF_123,RandomForest_r123,1449984,1546547,456,7710,456374,464540
RF_124,RandomForest_r124,1183744,1019936,456,7722,172263,180441
RF_125,RandomForest_r125,2228224,2431058,458,7710,1395837,1404005
RF_126,RandomForest_r126,3276800,3373515,456,7710,2597394,2605560
RF_127,RandomForest_r127,2228224,2431074,458,7722,1395861,1404041
RF_128,RandomForest_r128,655360,1018422,456,7710,172239,180405
RF_129,RandomForest_r129,1966080,2447346,458,7722,1419550,1427730
RF_130,RandomForest_r130,2228224,2601806,456,7710,1813304,1821470
RF_131,RandomForest_r131,2359296,2620578,458,7710,1852060,1860228
RF_132,RandomForest_r132,2646016,2939206,456,7722,2156244,2164422
RF_133,RandomForest_r133,2228224,2522710,456,7710,1544628,1552794
RF_134,RandomForest_r134,2752512,3371038,458,7722,2590574,2598754
RF_135,RandomForest_r135,2097152,2522768,456,7710,1544628,1552794
RF_136,RandomForest_r136,655360,1027774,458,7710,174355,182523
RF_137,RandomForest_r137,2097152,2429576,458,7722,1395861,1404041
RF_138,RandomForest_r138,1048576,1027658,458,7710,174355,182523
RF_139,RandomForest_r139,1441792,1748555,458,7722,832109,840289
RF_140,RandomForest_r140,655360,1018480,456,7710,172239,180405
RF_141,RandomForest_r141,2359296,2495751,458,7722,1580208,1588388
RF_142,RandomForest_r142,2232320,2495743,458,7710,1580184,1588352
RF_143,RandomForest_r143,2228224,2601864,456,7710,1813304,1821470
RF_144,RandomForest_r144,2752512,3073784,458,7722,2298858,2307038
RF_145,RandomForest_r145,1310720,1545165,456,7710,456374,464540
RF_146,RandomForest_r146,2752512,2601872,456,7722,1813328,1821506
RF_147,RandomForest_r147,1048576,1242007,458,7710,268384,276552
RF_148,RandomForest_r148,3407872,3807805,456,7722,3045792,3053970
RF_149,RandomForest_r149,2228224,2904805,458,7710,2136896,2145064
RF_150,RandomForest_r150,2359296,2594659,458,7710,1798771,1806939
RF_151,RandomForest_r151,3276800,3371975,456,7722,2597418,2605596
RF_152,RandomForest_r152,2359296,2447338,458,7710,1419526,1427694
RF_153,RandomForest_r153,2490368,2522718,456,7722,1544652,1552830
RF_154,RandomForest_r154,2359296,2522710,456,7710,1544628,1552794
RF_155,RandomForest_r155,1060864,1232857,456,7710,266268,274434
RF_156,RandomForest_r156,-4075520,1241965,458,7722,268408,276588
RF_157,RandomForest_r157,2359296,2754786,458,7710,1951909,1960077
RF_158,RandomForest_r158,3145728,3371096,458,7722,2590574,2598754
RF_159,RandomForest_r159,1179648,1240737,458,7710,267904,276072
RF_160,RandomForest_r160,1572864,1760273,456,7722,838313,846491
RF_161,RandomForest_r161,917504,1239751,458,7710,267584,275752
RF_162,RandomForest_r162,2359296,2594659,458,7710,1798771,1806939
RF_163,RandomForest_r163,1449984,1760976,458,7710,835925,844093
RF_164,RandomForest_r164,1966080,2447288,458,7722,1419550,1427730
RF_165,RandomForest_r165,2490368,2754844,458,7710,1951909,1960077
RF_166,RandomForest_r166,3670016,3807847,456,7710,3045768,3053934
RF_167,RandomForest_r167,2752512,2939206,456,7722,2156244,2164422
RF_168,RandomForest_r168,3407872,3807847,456,7710,3045768,3053934
RF_169,RandomForest_r169,917504,1027774,458,7710,174355,182523
RF_170,RandomForest_r170,1310720,1760331,456,7722,838313,846491
RF_171,RandomForest_r171,2359296,2601806,456,7710,1813304,1821470
RF_172,RandomForest_r172,2289664,2495751,458,7722,1580208,1588388
RF_173,RandomForest_r173,1179648,1545107,456,7710,456374,464540
RF_174,RandomForest_r174,1703936,1567599,458,7710,456362,464530
RF_175,RandomForest_r175,1441792,1760934,458,7722,835949,844129
RF_176,RandomForest_r176,2101248,2447338,458,7710,1419526,1427694
RF_177,RandomForest_r177,2490368,2904863,458,7710,2136896,2145064
RF_178,RandomForest_r178,2228224,2525470,458,7722,1620688,1628868
RF_179,RandomForest_r179,1441792,1760976,458,7710,835925,844093
RF_180,RandomForest_r180,786432,1232799,456,7710,266268,274434
RF_181,RandomForest_r181,1441792,1545065,456,7722,456398,464576
RF_182,RandomForest_r182,1310720,1760257,456,7710,838289,846455
RF_183,RandomForest_r183,2359296,2525412,458,7722,1620688,1628868
RF_184,RandomForest_r184,2621440,2527549,458,7710,1681802,1689970
RF_185,RandomForest_r185,2625536,2506932,458,7710,1471206,1479374
RF_186,RandomForest_r186,942080,1018496,456,7722,172263,180441
RF_187,RandomForest_r187,917504,1027716,458,7710,174355,182523
RF_188,RandomForest_r188,1200128,1240695,458,7722,267928,276108
RF_189,RandomForest_r189,2932736,2939190,456,7710,2156220,2164386
RF_190,RandomForest_r190,1069056,1232815,456,7722,266292,274470
RF_191,RandomForest_r191,2883584,2904863,458,7710,2136896,2145064
RF_192,RandomForest_r192,1310720,1545165,456,7710,456374,464540
RF_193,RandomForest_r193,2359296,2601872,456,7722,1813328,1821506
RF_194,RandomForest_r194,2494464,2594659,458,7710,1798771,1806939
RF_195,RandomForest_r195,2752512,3196867,458,7710,2395323,2403491
RF_196,RandomForest_r196,2228224,2594675,458,7722,1798795,1806975
RF_197,RandomForest_r197,2883584,3073768,458,7710,2298834,2307002
RF_198,RandomForest_r198,2121728,2429676,458,7710,1395837,1404005
RF_199,RandomForest_r199,2621440,2939148,456,7722,2156244,2164422
RF_200,RandomForest_r200,917504,1239867,458,7710,267584,275752
NN_TORCH_0,NeuralNetTorch_c1,262144,402120,396,7710,224889,232995
NN_TORCH_1,NeuralNetTorch_c2,262144,446538,414,7710,237946,246070
NN_TORCH_2,NeuralNetTorch_c3,151552,242834,412,7710,91037,99159
NN_TORCH_3,NeuralNetTorch_c4,151552,286433,429,7710,96736,104875
NN_TORCH_4,NeuralNetTorch_r1,0,741711,538,7710,530996,539244
NN_TORCH_5,NeuralNetTorch_r2,282624,189555,537,7710,21834,30081
NN_TORCH_6,NeuralNetTorch_r3,262144,359854,538,7710,168796,177044
NN_TORCH_7,NeuralNetTorch_r4,282624,190747,538,7710,33059,41307
NN_TORCH_8,NeuralNetTorch_r5,0,206401,537,7710,28174,36421
NN_TORCH_9,NeuralNetTorch_r6,151552,743992,537,7710,564555,572802
NN_TORCH_10,NeuralNetTorch_r7,151552,189534,537,7710,24787,33034
NN_TORCH_11,NeuralNetTorch_r8,0,379264,538,7710,187948,196196
NN_TORCH_12,NeuralNetTorch_r9,413696,387602,537,7710,165338,173585
NN_TORCH_13,NeuralNetTorch_r10,151552,406711,538,7710,228247,236495
NN_TORCH_14,NeuralNetTorch_r11,151552,531022,538,7710,339978,348226
NN_TORCH_15,NeuralNetTorch_r12,262144,206340,539,7710,19241,27490
NN_TORCH_16,NeuralNetTorch_r13,0,353073,538,7710,199621,207869
NN_TORCH_17,NeuralNetTorch_r14,413696,205768,539,7710,24641,32890
NN_TORCH_18,NeuralNetTorch_r15,151552,438142,538,7710,206565,214813
NN_TORCH_19,NeuralNetTorch_r16,323584,412643,539,7710,234647,242896
NN_TORCH_20,NeuralNetTorch_r17,544768,263851,538,7710,56938,65186
NN_TORCH_21,NeuralNetTorch_r18,151552,189588,538,7710,21334,29582
NN_TORCH_22,NeuralNetTorch_r19,413696,206172,539,7710,31122,39371
NN_TORCH_23,NeuralNetTorch_r20,0,206115,539,7710,18521,26770
NN_TORCH_24,NeuralNetTorch_r21,413696,189421,539,7710,28527,36776
NN_TORCH_25,NeuralNetTorch_r22,151552,759341,538,7710,580039,588287
NN_TORCH_26,NeuralNetTorch_r23,282624,200879,538,7710,22795,31043
NN_TORCH_27,NeuralNetTorch_r24,151552,594816,538,7710,385472,393720
NN_TORCH_28,NeuralNetTorch_r25,282624,331228,538,7710,177989,186237
NN_TORCH_29,NeuralNetTorch_r26,151552,281471,538,7710,87159,95407
NN_TORCH_30,NeuralNetTorch_r27,278528,278965,539,7710,91492,99741
NN_TORCH_31,NeuralNetTorch_r28,151552,678914,538,7710,499975,508223
NN_TORCH_32,NeuralNetTorch_r29,0,1258719,539,7710,1008841,1017090
NN_TORCH_33,NeuralNetTorch_r30,282624,705840,538,7710,455793,464041
NN_TORCH_34,NeuralNetTorch_r31,393216,302190,538,7710,103236,111484
NN_TORCH_35,NeuralNetTorch_r32,151552,201057,539,7710,18370,26619
NN_TORCH_36,NeuralNetTorch_r33,131072,211962,539,7710,34290,42539
NN_TORCH_37,NeuralNetTorch_r34,282624,292885,539,7710,58622,66871
NN_TORCH_38,NeuralNetTorch_r35,262144,292264,539,7710,92471,100720
NN_TORCH_39,NeuralNetTorch_r36,131072,238595,538,7710,37164,45412
NN_TORCH_40,NeuralNetTorch_r37,151552,357135,538,7710,129333,137581
NN_TORCH_41,NeuralNetTorch_r38,0,394498,538,7710,229181,237429
NN_TORCH_42,NeuralNetTorch_r39,413696,315330,538,7710,162269,170517
NN_TORCH_43,NeuralNetTorch_r40,262144,189712,538,7710,30623,38871
NN_TORCH_44,NeuralNetTorch_r41,413696,276868,539,7710,41084,49333
NN_TORCH_45,NeuralNetTorch_r42,282624,944273,538,7710,764575,772823
NN_TORCH_46,NeuralNetTorch_r43,0,206503,538,7710,26234,34482
NN_TORCH_47,NeuralNetTorch_r44,151552,232339,538,7710,28253,36501
NN_TORCH_48,NeuralNetTorch_r45,151552,189619,538,7710,25295,33543
NN_TORCH_49,NeuralNetTorch_r46,151552,441121,538,7710,275829,284077
NN_TORCH_50,NeuralNetTorch_r47,282624,670797,538,7710,490207,498455
NN_TORCH_51,NeuralNetTorch_r48,282624,200595,539,7710,20603,28852
NN_TORCH_52,NeuralNetTorch_r49,655360,328110,539,7710,118012,126261
NN_TORCH_53,NeuralNetTorch_r50,151552,206279,538,7710,26306,34554
NN_TORCH_54,NeuralNetTorch_r51,0,214334,540,7710,35452,43702
NN_TORCH_55,NeuralNetTorch_r52,282624,189431,538,7710,29543,37791
NN_TORCH_56,NeuralNetTorch_r53,0,426502,539,7710,272621,280870
NN_TORCH_57,NeuralNetTorch_r54,315392,237876,538,7710,37227,45475
NN_TORCH_58,NeuralNetTorch_r55,151552,189296,538,7710,28679,36927
NN_TORCH_59,NeuralNetTorch_r56,167936,508453,538,7710,317698,325946
NN_TORCH_60,NeuralNetTorch_r57,180224,988268,539,7710,777240,785489
NN_TORCH_61,NeuralNetTorch_r58,131072,721846,539,7710,511464,519713
NN_TORCH_62,NeuralNetTorch_r59,151552,1100195,538,7710,907738,915986
NN_TORCH_63,NeuralNetTorch_r60,151552,277671,538,7710,41092,49340
NN_TORCH_64,NeuralNetTorch_r61,131072,842253,539,7710,650506,658755
NN_TORCH_65,NeuralNetTorch_r62,151552,189197,538,7710,28607,36855
NN_TORCH_66,NeuralNetTorch_r63,282624,556627,538,7710,260047,268295
NN_TORCH_67,NeuralNetTorch_r64,544768,459047,539,7710,198470,206719
NN_TORCH_68,NeuralNetTorch_r65,0,277458,539,7710,57211,65460
NN_TORCH_69,NeuralNetTorch_r66,131072,275182,538,7710,96619,104867
NN_TORCH_70,NeuralNetTorch_r67,262144,215490,539,7710,38971,47220
NN_TORCH_71,NeuralNetTorch_r68,151552,392648,538,7710,201368,209616
NN_TORCH_72,NeuralNetTorch_r69,131072,726799,538,7710,545983,554231
NN_TORCH_73,NeuralNetTorch_r70,151552,211797,538,7710,26410,34658
NN_TORCH_74,NeuralNetTorch_r71,282624,189266,539,7710,29103,37352
NN_TORCH_75,NeuralNetTorch_r72,282624,201125,538,7710,17777,26025
NN_TORCH_76,NeuralNetTorch_r73,413696,280821,539,7710,65274,73523
NN_TORCH_77,NeuralNetTorch_r74,0,671309,538,7710,479530,487778
NN_TORCH_78,NeuralNetTorch_r75,0,212624,538,7710,34370,42618
NN_TORCH_79,NeuralNetTorch_r76,151552,206856,539,7710,30834,39083
NN_TORCH_80,NeuralNetTorch_r77,135168,944101,538,7710,764575,772823
NN_TORCH_81,NeuralNetTorch_r78,0,545162,539,7710,353722,361971
NN_TORCH_82,NeuralNetTorch_r79,151552,424893,538,7710,178822,187070
NN_TORCH_83,NeuralNetTorch_r80,131072,205852,538,7710,27386,35634
NN_TORCH_84,NeuralNetTorch_r81,151552,351984,538,7710,187157,195405
NN_TORCH_85,NeuralNetTorch_r82,0,728707,539,7710,549287,557536
NN_TORCH_86,NeuralNetTorch_r83,131072,355138,539,7710,108205,116454
NN_TORCH_87,NeuralNetTorch_r84,577536,189366,538,7710,22342,30590
NN_TORCH_88,NeuralNetTorch_r85,397312,319304,538,7710,128600,136848
NN_TORCH_89,NeuralNetTorch_r86,0,513382,539,7710,322082,330331
NN_TORCH_90,NeuralNetTorch_r87,544768,348537,539,7710,104909,113158
NN_TORCH_91,NeuralNetTorch_r88,151552,548925,539,7710,300288,308537
NN_TORCH_92,NeuralNetTorch_r89,0,710334,539,7710,529719,537968
NN_TORCH_93,NeuralNetTorch_r90,151552,263579,539,7710,43725,51974
NN_TORCH_94,NeuralNetTorch_r91,0,1232940,539,7710,1040602,1048851
NN_TORCH_95,NeuralNetTorch_r92,151552,556058,538,7710,260047,268295
NN_TORCH_96,NeuralNetTorch_r93,262144,189409,539,7710,16430,24679
NN_TORCH_97,NeuralNetTorch_r94,151552,373438,538,7710,174495,182743
NN_TORCH_98,NeuralNetTorch_r95,282624,353230,539,7710,174039,182288
NN_TORCH_99,NeuralNetTorch_r96,282624,509550,538,7710,299672,307920
NN_TORCH_100,NeuralNetTorch_r97,446464,968521,538,7710,788719,796967
NN_TORCH_101,NeuralNetTorch_r98,151552,450039,538,7710,258160,266408
NN_TORCH_102,NeuralNetTorch_r99,413696,205962,539,7710,21207,29456
NN_TORCH_103,NeuralNetTorch_r100,282624,217441,540,7710,20872,29122
NN_TORCH_104,NeuralNetTorch_r101,131072,953980,540,7710,704093,712343
NN_TORCH_105,NeuralNetTorch_r102,131072,308424,540,7710,37336,45586
NN_TORCH_106,NeuralNetTorch_r103,0,571176,540,7710,360916,369166
NN_TORCH_107,NeuralNetTorch_r104,413696,205941,540,7710,22053,30303
NN_TORCH_108,NeuralNetTorch_r105,262144,363825,540,7710,64752,73002
NN_TORCH_109,NeuralNetTorch_r106,151552,573207,540,7710,382094,390344
NN_TORCH_110,NeuralNetTorch_r107,282624,189496,539,7710,25011,33260
NN_TORCH_111,NeuralNetTorch_r108,393216,206384,540,7710,21621,29871
NN_TORCH_112,NeuralNetTorch_r109,413696,243240,539,7710,52823,61072
NN_TORCH_113,NeuralNetTorch_r110,413696,288091,539,7710,103151,111400
NN_TORCH_114,NeuralNetTorch_r111,282624,341607,539,7710,145664,153913
NN_TORCH_115,NeuralNetTorch_r112,262144,378688,539,7710,109113,117362
NN_TORCH_116,NeuralNetTorch_r113,151552,412286,539,7710,200803,209052
NN_TORCH_117,NeuralNetTorch_r114,151552,897103,539,7710,717443,725692
NN_TORCH_118,NeuralNetTorch_r115,131072,621102,540,7710,441219,449469
NN_TORCH_119,NeuralNetTorch_r116,282624,200967,540,7710,28791,37041
NN_TORCH_120,NeuralNetTorch_r117,151552,503647,540,7710,226554,234804
NN_TORCH_121,NeuralNetTorch_r118,151552,281465,540,7710,87155,95405
NN_TORCH_122,NeuralNetTorch_r119,151552,206390,539,7710,20549,28798
NN_TORCH_123,NeuralNetTorch_r120,413696,273712,540,7710,39336,47586
NN_TORCH_124,NeuralNetTorch_r121,0,1209130,540,7710,1016486,1024736
NN_TORCH_125,NeuralNetTorch_r122,262144,304566,540,7710,35008,43258
NN_TORCH_126,NeuralNetTorch_r123,413696,239854,540,7710,32250,40500
NN_TORCH_127,NeuralNetTorch_r124,413696,496544,539,7710,316611,324860
NN_TORCH_128,NeuralNetTorch_r125,413696,329976,539,7710,95417,103666
NN_TORCH_129,NeuralNetTorch_r126,282624,438268,540,7710,218275,226525
NN_TORCH_130,NeuralNetTorch_r127,0,994468,539,7710,783276,791525
NN_TORCH_131,NeuralNetTorch_r128,315392,355450,539,7710,138760,147009
NN_TORCH_132,NeuralNetTorch_r129,151552,289697,539,7710,99132,107381
NN_TORCH_133,NeuralNetTorch_r130,151552,296124,539,7710,94667,102916
NN_TORCH_134,NeuralNetTorch_r131,0,208348,539,7710,32358,40607
NN_TORCH_135,NeuralNetTorch_r132,282624,807406,540,7710,627771,636021
NN_TORCH_136,NeuralNetTorch_r133,131072,499105,540,7710,288868,297118
NN_TORCH_137,NeuralNetTorch_r134,323584,541049,540,7710,361179,369429
NN_TORCH_138,NeuralNetTorch_r135,151552,629104,539,7710,380797,389046
NN_TORCH_139,NeuralNetTorch_r136,282624,465252,539,7710,236563,244812
NN_TORCH_140,NeuralNetTorch_r137,131072,210874,539,7710,23623,31872
NN_TORCH_141,NeuralNetTorch_r138,151552,200790,539,7710,16941,25190
NN_TORCH_142,NeuralNetTorch_r139,413696,424543,540,7710,173434,181684
NN_TORCH_143,NeuralNetTorch_r140,524288,249579,539,7710,55975,64224
NN_TORCH_144,NeuralNetTorch_r141,413696,290511,540,7710,97256,105506
NN_TORCH_145,NeuralNetTorch_r142,131072,1069516,540,7710,820645,828895
NN_TORCH_146,NeuralNetTorch_r143,282624,1027071,539,7710,778461,786710
NN_TORCH_147,NeuralNetTorch_r144,0,321544,539,7710,63896,72145
NN_TORCH_148,NeuralNetTorch_r145,0,300908,539,7710,110852,119101
NN_TORCH_149,NeuralNetTorch_r146,151552,434823,540,7710,280801,289051
NN_TORCH_150,NeuralNetTorch_r147,151552,189567,540,7710,21258,29508
NN_TORCH_151,NeuralNetTorch_r148,0,638510,540,7710,428308,436558
NN_TORCH_152,NeuralNetTorch_r149,282624,295516,539,7710,104892,113141
NN_TORCH_153,NeuralNetTorch_r150,262144,353201,539,7710,174051,182300
NN_TORCH_154,NeuralNetTorch_r151,151552,385397,539,7710,231809,240058
NN_TORCH_155,NeuralNetTorch_r152,131072,479939,540,7710,288396,296646
NN_TORCH_156,NeuralNetTorch_r153,151552,573466,539,7710,407361,415610
NN_TORCH_157,NeuralNetTorch_r154,131072,1036629,539,7710,826116,834365
NN_TORCH_158,NeuralNetTorch_r155,188416,259408,540,7710,54694,62944
NN_TORCH_159,NeuralNetTorch_r156,151552,668874,539,7710,419901,428150
NN_TORCH_160,NeuralNetTorch_r157,0,1151304,540,7710,900989,909239
NN_TORCH_161,NeuralNetTorch_r158,151552,544315,539,7710,241122,249371
NN_TORCH_162,NeuralNetTorch_r159,282624,252470,540,7710,44615,52865
NN_TORCH_163,NeuralNetTorch_r160,151552,1100176,539,7710,907742,915991
NN_TORCH_164,NeuralNetTorch_r161,151552,252926,540,7710,44615,52865
NN_TORCH_165,NeuralNetTorch_r162,282624,310996,540,7710,89049,97299
NN_TORCH_166,NeuralNetTorch_r163,262144,206293,539,7710,26093,34342
NN_TORCH_167,NeuralNetTorch_r164,192512,189475,540,7710,26875,35125
NN_TORCH_168,NeuralNetTorch_r165,282624,211425,540,7710,22014,30264
NN_TORCH_169,NeuralNetTorch_r166,544768,200395,540,7710,28335,36585
NN_TORCH_170,NeuralNetTorch_r167,413696,189545,539,7710,27387,35636
NN_TORCH_171,NeuralNetTorch_r168,282624,367145,540,7710,213601,221851
NN_TORCH_172,NeuralNetTorch_r169,184320,239394,540,7710,31673,39923
NN_TORCH_173,NeuralNetTorch_r170,151552,557646,539,7710,308733,316982
NN_TORCH_174,NeuralNetTorch_r171,262144,256616,540,7710,87303,95553
NN_TORCH_175,NeuralNetTorch_r172,151552,443155,540,7710,264675,272925
NN_TORCH_176,NeuralNetTorch_r173,282624,206371,540,7710,27526,35776
NN_TORCH_177,NeuralNetTorch_r174,278528,676237,539,7710,484982,493231
NN_TORCH_178,NeuralNetTorch_r175,413696,189533,540,7710,16722,24972
NN_TORCH_179,NeuralNetTorch_r176,0,401039,540,7710,221403,229653
NN_TORCH_180,NeuralNetTorch_r177,262144,287942,539,7710,56282,64531
NN_TORCH_181,NeuralNetTorch_r178,282624,189485,540,7710,20250,28500
NN_TORCH_182,NeuralNetTorch_r179,131072,303181,540,7710,75203,83453
NN_TORCH_183,NeuralNetTorch_r180,151552,353083,539,7710,127489,135738
NN_TORCH_184,NeuralNetTorch_r181,151552,353597,539,7710,127489,135738
NN_TORCH_185,NeuralNetTorch_r182,151552,189480,540,7710,20178,28428
NN_TORCH_186,NeuralNetTorch_r183,0,728792,539,7710,549299,557548
NN_TORCH_187,NeuralNetTorch_r184,131072,376137,539,7710,222609,230858
NN_TORCH_188,NeuralNetTorch_r185,262144,528368,540,7710,318148,326398
NN_TORCH_189,NeuralNetTorch_r186,151552,818018,540,7710,638643,646893
NN_TORCH_190,NeuralNetTorch_r187,151552,402569,539,7710,248873,257122
NN_TORCH_191,NeuralNetTorch_r188,131072,449145,540,7710,295417,303667
NN_TORCH_192,NeuralNetTorch_r189,151552,798380,540,7710,606774,615024
NN_TORCH_193,NeuralNetTorch_r190,0,730131,540,7710,550083,558333
NN_TORCH_194,NeuralNetTorch_r191,0,206098,539,7710,30270,38519
NN_TORCH_195,NeuralNetTorch_r192,131072,694051,539,7710,513731,521980
NN_TORCH_196,NeuralNetTorch_r193,151552,329365,539,7710,164601,172850
NN_TORCH_197,NeuralNetTorch_r194,544768,416324,540,7710,167370,175620
NN_TORCH_198,NeuralNetTorch_r195,151552,189394,540,7710,27091,35341
NN_TORCH_199,NeuralNetTorch_r196,401408,189293,539,7710,23354,31603
NN_TORCH_200,NeuralNetTorch_r197,282624,190447,539,7710,33003,41252
NN_TORCH_201,NeuralNetTorch_r198,282624,451169,540,7710,297564,305814
NN_TORCH_202,NeuralNetTorch_r199,0,493731,539,7710,315251,323500
NN_TORCH_203,NeuralNetTorch_r200,282624,319422,539,7710,128604,136853
LR_0,LinearModel_c1,0,145982,390,7710,10806,18906
LR_1,LinearModel_c2,151552,146036,414,7710,10825,18949
LR_2,LinearModel_r1,0,146310,474,7710,10895,19079
LR_3,LinearModel_r2,0,146193,472,7710,10893,19075
LR_4,LinearModel_r3,0,146360,480,7710,10909,19099
LR_5,LinearModel_r4,0,146198,482,7710,10911,19103
LR_6,LinearModel_r5,143360,146431,482,7710,10911,19103
LR_7,LinearModel_r6,151552,146188,480,7710,10909,19099
LR_8,LinearModel_r7,282624,146427,474,7710,10895,19079
LR_9,LinearModel_r8,151552,146426,480,7710,10909,19099
LR_10,LinearModel_r9,0,146316,472,7710,10893,19075
LR_11,LinearModel_r10,0,146375,475,7710,10899,19084
LR_12,LinearModel_r11,151552,146316,473,7710,10897,19080
LR_13,LinearModel_r12,0,146205,475,7710,10899,19084
LR_14,LinearModel_r13,0,146362,475,7710,10899,19084
LR_15,LinearModel_r14,151552,146433,483,7710,10915,19108
LR_16,LinearModel_r15,0,146112,483,7710,10915,19108
LR_17,LinearModel_r16,282624,146335,481,7710,10913,19104
LR_18,LinearModel_r17,131072,146163,481,7710,10913,19104
LR_19,LinearModel_r18,135168,146333,481,7710,10913,19104
LR_20,LinearModel_r19,151552,146275,475,7710,10899,19084
LR_21,LinearModel_r20,151552,146400,481,7710,10913,19104
LR_22,LinearModel_r21,151552,146334,481,7710,10913,19104
LR_23,LinearModel_r22,180224,146278,481,7710,10913,19104
LR_24,LinearModel_r23,131072,146079,483,7710,10915,19108
LR_25,LinearModel_r24,282624,146285,481,7710,10913,19104
LR_26,LinearModel_r25,0,146096,481,7710,10913,19104
LR_27,LinearModel_r26,151552,146213,473,7710,10897,19080
LR_28,LinearModel_r27,163840,146324,483,7710,10915,19108
LR_29,LinearModel_r28,307200,146158,483,7710,10915,19108
LR_30,LinearModel_r29,0,146229,483,7710,10915,19108
LR_31,LinearModel_r30,151552,146100,473,7710,10897,19080
LR_32,LinearModel_r31,131072,146165,481,7710,10913,19104
LR_33,LinearModel_r32,0,146111,483,7710,10915,19108
LR_34,LinearModel_r33,0,146344,475,7710,10899,19084
LR_35,LinearModel_r34,0,145979,481,7710,10913,19104
LR_36,LinearModel_r35,151552,146096,483,7710,10915,19108
LR_37,LinearModel_r36,0,146327,483,7710,10915,19108
LR_38,LinearModel_r37,151552,146396,475,7710,10899,19084
LR_39,LinearModel_r38,282624,146098,483,7710,10915,19108
LR_40,LinearModel_r39,0,146030,481,7710,10913,19104
LR_41,LinearModel_r40,151552,146095,483,7710,10915,19108
LR_42,LinearModel_r41,282624,146094,483,7710,10915,19108
LR_43,LinearModel_r42,151552,146154,483,7710,10915,19108
LR_44,LinearModel_r43,0,146282,483,7710,10915,19108
LR_45,LinearModel_r44,0,146275,483,7710,10915,19108
LR_46,LinearModel_r45,0,146324,481,7710,10913,19104
LR_47,LinearModel_r46,151552,146512,481,7710,10913,19104
LR_48,LinearModel_r47,0,146214,483,7710,10915,19108
LR_49,LinearModel_r48,151552,146075,481,7710,10913,19104
LR_50,LinearModel_r49,0,146212,481,7710,10913,19104
LR_51,LinearModel_r50,0,146155,483,7710,10915,19108
GBM_0,LightGBM_c1,131072,109340,391,7710,19572,27673
GBM_1,LightGBM_c2,0,109315,407,7710,17251,25368
GBM_2,LightGBM_c3,151552,109623,481,7722,17595,25798
GBM_3,LightGBM_c4,188416,135830,496,7722,29847,38065
GBM_4,LightGBM_r1,0,441749,496,7710,193324,201530
GBM_5,LightGBM_r2,0,152784,496,7722,35479,43697
GBM_6,LightGBM_r3,0,110210,496,7710,13271,21477
GBM_7,LightGBM_r4,262144,256784,496,7722,70165,78383
GBM_8,LightGBM_r5,151552,110258,496,7722,13285,21503
GBM_9,LightGBM_r6,147456,110081,496,7722,13485,21703
GBM_10,LightGBM_r7,0,109981,496,7710,18176,26382
GBM_11,LightGBM_r8,0,110085,496,7722,20340,28558
GBM_12,LightGBM_r9,192512,231227,496,7722,61646,69864
GBM_13,LightGBM_r10,0,222831,497,7710,83896,92103
GBM_14,LightGBM_r11,0,110151,497,7722,20814,29033
GBM_15,LightGBM_r12,319488,214986,497,7722,79994,88213
GBM_16,LightGBM_r13,0,119014,497,7710,24247,32454
GBM_17,LightGBM_r14,147456,110094,497,7722,15996,24215
GBM_18,LightGBM_r15,278528,113690,497,7722,22469,30688
GBM_19,LightGBM_r16,0,125408,497,7710,26359,34566
GBM_20,LightGBM_r17,192512,110264,497,7722,20958,29177
GBM_21,LightGBM_r18,0,138171,497,7722,30610,38829
GBM_22,LightGBM_r19,0,110100,497,7710,14939,23146
GBM_23,LightGBM_r20,0,110151,497,7722,19631,27850
GBM_24,LightGBM_r21,131072,109905,497,7722,19192,27411
GBM_25,LightGBM_r22,0,223876,497,7710,59201,67408
GBM_26,LightGBM_r23,0,210646,497,7722,77795,86014
GBM_27,LightGBM_r24,131072,182777,497,7722,45498,53717
GBM_28,LightGBM_r25,151552,110370,497,7722,13384,21603
GBM_29,LightGBM_r26,413696,220983,497,7710,58198,66405
GBM_30,LightGBM_r27,0,170295,497,7722,41318,49537
GBM_31,LightGBM_r28,0,148811,497,7722,34176,42395
GBM_32,LightGBM_r29,131072,117057,497,7710,23556,31763
GBM_33,LightGBM_r30,307200,219473,497,7722,57730,65949
GBM_34,LightGBM_r31,0,110307,497,7722,17631,25850
GBM_35,LightGBM_r32,0,110156,497,7710,17978,26185
GBM_36,LightGBM_r33,151552,207600,497,7722,53753,61972
GBM_37,LightGBM_r34,131072,109984,497,7722,13711,21930
GBM_38,LightGBM_r35,262144,186029,497,7710,46566,54773
GBM_39,LightGBM_r36,0,110146,497,7722,20790,29009
GBM_40,LightGBM_r37,0,109971,497,7722,13400,21619
GBM_41,LightGBM_r38,0,349172,497,7710,147042,155249
GBM_42,LightGBM_r39,0,228668,497,7722,60795,69014
GBM_43,LightGBM_r40,131072,120696,497,7722,24785,33004
GBM_44,LightGBM_r41,0,110100,497,7710,16234,24441
GBM_45,LightGBM_r42,167936,110150,497,7722,13936,22155
GBM_46,LightGBM_r43,131072,110089,497,7722,19314,27533
GBM_47,LightGBM_r44,147456,254016,497,7710,69209,77416
GBM_48,LightGBM_r45,167936,211499,497,7722,55072,63291
GBM_49,LightGBM_r46,0,242483,497,7722,65400,73619
GBM_50,LightGBM_r47,282624,109993,497,7710,13693,21900
GBM_51,LightGBM_r48,131072,110206,497,7722,13177,21396
GBM_52,LightGBM_r49,0,110086,497,7722,13387,21606
GBM_53,LightGBM_r50,0,117701,497,7722,23806,32025
GBM_54,LightGBM_r51,0,109991,497,7710,16725,24932
GBM_55,LightGBM_r52,0,253761,497,7722,69140,77359
GBM_56,LightGBM_r53,0,110206,497,7722,18198,26417
GBM_57,LightGBM_r54,184320,227166,497,7710,60259,68466
GBM_58,LightGBM_r55,0,110033,497,7722,18267,26486
GBM_59,LightGBM_r56,151552,283436,497,7722,114190,122409
GBM_60,LightGBM_r57,131072,124131,497,7710,25914,34121
GBM_61,LightGBM_r58,131072,110208,497,7722,14689,22908
GBM_62,LightGBM_r59,0,110143,497,7722,13401,21620
GBM_63,LightGBM_r60,0,150081,497,7710,34564,42771
GBM_64,LightGBM_r61,176128,110148,497,7722,17538,25757
GBM_65,LightGBM_r62,0,110149,497,7722,13300,21519
GBM_66,LightGBM_r63,0,208317,497,7710,53976,62183
GBM_67,LightGBM_r64,0,236130,497,7722,63263,71482
GBM_68,LightGBM_r65,131072,117942,497,7722,23867,32086
GBM_69,LightGBM_r66,430080,111305,497,7710,21658,29865
GBM_70,LightGBM_r67,0,110217,497,7722,21292,29511
GBM_71,LightGBM_r68,0,111216,497,7722,21625,29844
GBM_72,LightGBM_r69,0,286561,497,7710,115790,123997
GBM_73,LightGBM_r70,131072,115829,497,7722,23182,31401
GBM_74,LightGBM_r71,151552,132803,497,7722,28840,37059
GBM_75,LightGBM_r72,192512,231414,497,7710,61675,69882
GBM_76,LightGBM_r73,131072,110088,497,7722,20159,28378
GBM_77,LightGBM_r74,131072,189029,497,7722,47582,55801
GBM_78,LightGBM_r75,262144,110047,497,7710,13905,22112
GBM_79,LightGBM_r76,151552,207720,497,7722,76332,84551
GBM_80,LightGBM_r77,0,245588,497,7722,66435,74654
GBM_81,LightGBM_r78,0,116546,497,7710,23405,31612
GBM_82,LightGBM_r79,0,194798,497,7722,49505,57724
GBM_83,LightGBM_r80,0,110142,497,7722,13292,21511
GBM_84,LightGBM_r81,0,213345,497,7722,55668,63887
GBM_85,LightGBM_r82,131072,166662,497,7710,40091,48298
GBM_86,LightGBM_r83,184320,155685,497,7722,36448,44667
GBM_87,LightGBM_r84,151552,109922,497,7722,13301,21520
GBM_88,LightGBM_r85,0,110216,497,7710,18021,26228
GBM_89,LightGBM_r86,172032,136392,497,7722,30017,38236
GBM_90,LightGBM_r87,0,424350,497,7722,184647,192866
GBM_91,LightGBM_r88,184320,268218,497,7710,106594,114801
GBM_92,LightGBM_r89,188416,239312,497,7722,64343,72562
GBM_93,LightGBM_r90,0,109916,497,7722,19160,27379
GBM_94,LightGBM_r91,131072,113853,497,7710,22488,30695
GBM_95,LightGBM_r92,0,140240,497,7722,31319,39538
GBM_96,LightGBM_r93,0,110206,497,7722,13709,21928
GBM_97,LightGBM_r94,176128,146849,497,7710,33506,41713
GBM_98,LightGBM_r95,131072,246695,497,7722,66804,75023
GBM_99,LightGBM_r96,0,264842,497,7722,73377,81596
GBM_100,LightGBM_r97,303104,110087,497,7722,13188,21407
GBM_101,LightGBM_r98,147456,230265,497,7710,61292,69499
GBM_102,LightGBM_r99,0,159569,497,7722,37762,45981
GBM_103,LightGBM_r100,0,135617,498,7722,29780,38000
GBM_104,LightGBM_r101,0,109998,498,7710,13917,22125
GBM_105,LightGBM_r102,131072,110151,498,7722,13291,21511
GBM_106,LightGBM_r103,0,214374,498,7722,56013,64233
GBM_107,LightGBM_r104,0,110161,498,7710,15242,23450
GBM_108,LightGBM_r105,0,109920,498,7722,17850,26070
GBM_109,LightGBM_r106,323584,172166,498,7722,41963,50183
GBM_110,LightGBM_r107,131072,187056,498,7710,46891,55099
GBM_111,LightGBM_r108,131072,110212,498,7722,13179,21399
GBM_112,LightGBM_r109,282624,159669,498,7722,37778,45998
GBM_113,LightGBM_r110,188416,127461,498,7722,27042,35262
GBM_114,LightGBM_r111,0,605427,498,7710,275167,283375
GBM_115,LightGBM_r112,401408,213166,498,7722,54666,62886
GBM_116,LightGBM_r113,131072,114461,498,7710,13465,21673
GBM_117,LightGBM_r114,167936,210237,498,7722,76118,84338
GBM_118,LightGBM_r115,176128,157290,498,7722,36002,44222
GBM_119,LightGBM_r116,0,114463,498,7710,19872,28080
GBM_120,LightGBM_r117,0,255519,498,7722,68745,76965
GBM_121,LightGBM_r118,266240,123423,498,7722,24713,32933
GBM_122,LightGBM_r119,323584,235746,498,7722,62154,70374
GBM_123,LightGBM_r120,0,324731,498,7710,133378,141586
GBM_124,LightGBM_r121,0,159972,498,7722,36896,45116
GBM_125,LightGBM_r122,176128,110063,498,7722,21262,29482
GBM_126,LightGBM_r123,0,290678,498,7710,117797,126005
GBM_127,LightGBM_r124,135168,109991,498,7722,21238,29458
GBM_128,LightGBM_r125,307200,215082,498,7722,80015,88235
GBM_129,LightGBM_r126,0,110048,498,7710,13266,21474
GBM_130,LightGBM_r127,188416,171629,498,7722,41784,50004
GBM_131,LightGBM_r128,172032,119001,498,7722,24222,32442
GBM_132,LightGBM_r129,131072,138158,498,7710,30611,38819
GBM_133,LightGBM_r130,147456,110094,498,7722,13181,21401
GBM_134,LightGBM_r131,151552,120251,498,7722,24658,32878
GBM_135,LightGBM_r132,0,110110,498,7710,13267,21475
GBM_136,LightGBM_r133,192512,110154,498,7722,16700,24920
GBM_137,LightGBM_r134,0,110105,498,7722,19095,27315
GBM_138,LightGBM_r135,135168,110149,498,7722,13301,21521
GBM_139,LightGBM_r136,131072,110106,498,7710,13379,21587
GBM_140,LightGBM_r137,151552,272133,498,7722,108536,116756
GBM_141,LightGBM_r138,131072,110096,498,7722,20153,28373
GBM_142,LightGBM_r139,131072,109871,498,7710,13380,21588
GBM_143,LightGBM_r140,0,110270,498,7722,13718,21938
GBM_144,LightGBM_r141,0,110206,498,7722,18901,27121
GBM_145,LightGBM_r142,192512,326240,498,7710,135607,143815
GBM_146,LightGBM_r143,131072,132515,498,7722,28746,36966
GBM_147,LightGBM_r144,0,110093,498,7722,13181,21401
GBM_148,LightGBM_r145,0,109818,498,7710,20656,28864
GBM_149,LightGBM_r146,131072,110153,498,7722,13303,21523
GBM_150,LightGBM_r147,0,110038,498,7722,17086,25306
GBM_151,LightGBM_r148,163840,110107,498,7710,19184,27392
GBM_152,LightGBM_r149,0,806078,498,7722,375542,383762
GBM_153,LightGBM_r150,131072,204428,498,7722,52717,60937
GBM_154,LightGBM_r151,0,110222,498,7710,16376,24584
GBM_155,LightGBM_r152,131072,137865,498,7722,30510,38730
GBM_156,LightGBM_r153,0,109989,498,7722,15102,23322
GBM_157,LightGBM_r154,0,184215,498,7722,45960,54180
GBM_158,LightGBM_r155,131072,138699,498,7710,30772,38980
GBM_159,LightGBM_r156,0,217560,498,7722,81254,89474
GBM_160,LightGBM_r157,282624,110089,498,7722,18403,26623
GBM_161,LightGBM_r158,0,110050,498,7710,13582,21790
GBM_162,LightGBM_r159,282624,196038,498,7722,49901,58121
GBM_163,LightGBM_r160,0,199644,498,7722,51103,59323
GBM_164,LightGBM_r161,0,151575,498,7710,35064,43272
GBM_165,LightGBM_r162,192512,260373,498,7722,71346,79566
GBM_166,LightGBM_r163,151552,110091,498,7722,13306,21526
GBM_167,LightGBM_r164,135168,120251,498,7710,24642,32850
GBM_168,LightGBM_r165,0,110154,498,7722,14182,22402
GBM_169,LightGBM_r166,131072,522566,498,7722,233744,241964
GBM_170,LightGBM_r167,143360,247719,498,7710,67112,75320
GBM_171,LightGBM_r168,192512,263700,498,7722,72842,81062
GBM_172,LightGBM_r169,151552,373340,498,7722,159202,167422
GBM_173,LightGBM_r170,262144,126269,498,7710,26648,34856
GBM_174,LightGBM_r171,0,150528,498,7722,34731,42951
GBM_175,LightGBM_r172,131072,143841,498,7722,32502,40722
GBM_176,LightGBM_r173,151552,110177,498,7722,13489,21709
GBM_177,LightGBM_r174,151552,110071,498,7710,13366,21574
GBM_178,LightGBM_r175,184320,414982,498,7722,179965,188185
GBM_179,LightGBM_r176,131072,127854,498,7710,27157,35365
GBM_180,LightGBM_r177,151552,288650,498,7722,116828,125048
GBM_181,LightGBM_r178,323584,158535,498,7722,37400,45620
GBM_182,LightGBM_r179,131072,147263,498,7722,33662,41882
GBM_183,LightGBM_r180,151552,110129,498,7710,17447,25655
GBM_184,LightGBM_r181,0,188426,498,7722,47383,55603
GBM_185,LightGBM_r182,131072,110172,498,7722,17106,25326
GBM_186,LightGBM_r183,131072,190134,498,7710,47911,56119
GBM_187,LightGBM_r184,131072,110228,498,7722,16029,24249
GBM_188,LightGBM_r185,131072,128567,498,7722,27424,35644
GBM_189,LightGBM_r186,0,222636,498,7710,58745,66953
GBM_190,LightGBM_r187,0,259986,498,7722,102429,110649
GBM_191,LightGBM_r188,0,197707,498,7722,50432,58652
GBM_192,LightGBM_r189,0,110128,498,7710,19359,27567
GBM_193,LightGBM_r190,151552,110064,498,7722,18303,26523
GBM_194,LightGBM_r191,131072,110346,498,7722,17670,25890
GBM_195,LightGBM_r192,0,110106,498,7710,16648,24856
GBM_196,LightGBM_r193,0,123421,498,7722,25734,33954
GBM_197,LightGBM_r194,0,111887,498,7722,21870,30090
GBM_198,LightGBM_r195,131072,109982,498,7710,16862,25070
GBM_199,LightGBM_r196,0,387654,498,7722,166330,174550
GBM_200,LightGBM_r197,131072,228968,498,7722,60897,69117
GBM_201,LightGBM_r198,0,183500,498,7710,45725,53933
GBM_202,LightGBM_r199,0,149789,498,7722,34504,42724
GBM_203,LightGBM_r200,180224,809392,498,7722,377170,385390
KNN_0,KNeighbors_c1,131072,348962,412,7710,76006,84128
KNN_1,KNeighbors_c2,827392,353214,413,7722,76031,84166
KNN_2,KNeighbors_r1,393216,352267,434,7722,76065,84221
KNN_3,KNeighbors_r2,131072,361429,435,7722,76066,84223
KNN_4,KNeighbors_r3,303104,350522,435,7722,76066,84223
KNN_5,KNeighbors_r4,266240,412607,434,7710,76041,84185
KNN_6,KNeighbors_r5,262144,345806,435,7722,76066,84223
KNN_7,KNeighbors_r6,131072,368177,434,7722,76065,84221
KNN_8,KNeighbors_r7,262144,365742,434,7722,76065,84221
KNN_9,KNeighbors_r8,131072,388444,434,7722,76065,84221
KNN_10,KNeighbors_r9,0,401811,435,7710,76042,84187
KNN_11,KNeighbors_r10,401408,361817,435,7722,76069,84226
KNN_12,KNeighbors_r11,262144,364343,435,7722,76069,84226
KNN_13,KNeighbors_r12,393216,343650,435,7722,76069,84226
KNN_14,KNeighbors_r13,524288,348371,435,7722,76069,84226
KNN_15,KNeighbors_r14,393216,385855,436,7710,76046,84192
KNN_16,KNeighbors_r15,815104,353286,435,7722,76069,84226
KNN_17,KNeighbors_r16,524288,362797,436,7722,76070,84228
KNN_18,KNeighbors_r17,131072,347434,436,7722,76070,84228
KNN_19,KNeighbors_r18,262144,363472,436,7722,76070,84228
KNN_20,KNeighbors_r19,393216,368665,436,7722,76070,84228
KNN_21,KNeighbors_r20,131072,359093,436,7710,76046,84192
KNN_22,KNeighbors_r21,442368,342818,436,7722,76070,84228
KNN_23,KNeighbors_r22,131072,350277,435,7722,76069,84226
KNN_24,KNeighbors_r23,262144,342652,435,7722,76069,84226
KNN_25,KNeighbors_r24,393216,348443,435,7722,76069,84226
KNN_26,KNeighbors_r25,544768,349552,435,7710,76045,84190
KNN_27,KNeighbors_r26,393216,365516,435,7722,76069,84226
KNN_28,KNeighbors_r27,262144,362153,436,7722,76070,84228
KNN_29,KNeighbors_r28,262144,350038,436,7722,76070,84228
KNN_30,KNeighbors_r29,393216,357233,436,7722,76070,84228
KNN_31,KNeighbors_r30,131072,362700,435,7710,76045,84190
KNN_32,KNeighbors_r31,524288,354388,436,7722,76070,84228
KNN_33,KNeighbors_r32,405504,444472,436,7722,76070,84228
KNN_34,KNeighbors_r33,131072,348676,435,7722,76069,84226
KNN_35,KNeighbors_r34,131072,378017,436,7722,76070,84228
KNN_36,KNeighbors_r35,262144,361061,435,7710,76045,84190
KNN_37,KNeighbors_r36,667648,370557,436,7722,76070,84228
KNN_38,KNeighbors_r37,0,360020,436,7722,76070,84228
KNN_39,KNeighbors_r38,393216,345657,436,7722,76070,84228
KNN_40,KNeighbors_r39,393216,348527,435,7722,76069,84226
KNN_41,KNeighbors_r40,524288,355225,436,7722,76070,84228
KNN_42,KNeighbors_r41,397312,347222,435,7710,76045,84190
KNN_43,KNeighbors_r42,540672,445642,436,7722,76070,84228
KNN_44,KNeighbors_r43,397312,341531,435,7722,76069,84226
KNN_45,KNeighbors_r44,262144,359488,435,7722,76069,84226
KNN_46,KNeighbors_r45,655360,395239,435,7722,76069,84226
KNN_47,KNeighbors_r46,393216,387557,435,7710,76045,84190
KNN_48,KNeighbors_r47,262144,356399,435,7722,76069,84226
KNN_49,KNeighbors_r48,131072,356816,436,7722,76070,84228
KNN_50,KNeighbors_r49,393216,370217,436,7722,76070,84228
KNN_51,KNeighbors_r50,0,409751,435,7722,76069,84226
FT_TRANSFORMER_0,FTTransformer_c1,397312,684629,402,7710,8518,16630
FT_TRANSFORMER_1,FTTransformer_c2,663552,695876,572,7710,8682,16964
FT_TRANSFORMER_2,FTTransformer_c3,401408,693078,572,7710,8682,16964
FT_TRANSFORMER_3,FTTransformer_c4,3805184,692149,572,7710,8682,16964
FT_TRANSFORMER_4,FTTransformer_c5,663552,692708,575,7710,8685,16970
FT_TRANSFORMER_5,FTTransformer_c6,401408,690683,573,7710,8683,16966
FT_TRANSFORMER_6,FTTransformer_c7,401408,692285,573,7710,8683,16966
FASTAI_0,NeuralNetFastAI_c1,0,336206,394,7710,9238,17342
FASTAI_1,NeuralNetFastAI_r1,131072,394709,480,7710,9336,17526
FASTAI_2,NeuralNetFastAI_r2,262144,422239,482,7710,9338,17530
FASTAI_3,NeuralNetFastAI_r3,131072,360412,481,7710,9336,17527
FASTAI_4,NeuralNetFastAI_r4,131072,316882,476,7710,9332,17518
FASTAI_5,NeuralNetFastAI_r5,131072,316889,477,7710,9333,17520
FASTAI_6,NeuralNetFastAI_r6,0,319891,476,7710,9332,17518
FASTAI_7,NeuralNetFastAI_r7,131072,405812,481,7710,9337,17528
FASTAI_8,NeuralNetFastAI_r8,262144,339296,481,7710,9337,17528
FASTAI_9,NeuralNetFastAI_r9,131072,317300,477,7710,9333,17520
FASTAI_10,NeuralNetFastAI_r10,0,400392,477,7710,9336,17523
FASTAI_11,NeuralNetFastAI_r11,131072,343625,481,7710,9339,17530
FASTAI_12,NeuralNetFastAI_r12,131072,402381,482,7710,9341,17533
FASTAI_13,NeuralNetFastAI_r13,262144,452717,482,7710,9341,17533
FASTAI_14,NeuralNetFastAI_r14,262144,362025,482,7710,9340,17532
FASTAI_15,NeuralNetFastAI_r15,131072,406550,480,7710,9339,17529
FASTAI_16,NeuralNetFastAI_r16,131072,345551,479,7710,9337,17526
FASTAI_17,NeuralNetFastAI_r17,131072,425047,483,7710,9342,17535
FASTAI_18,NeuralNetFastAI_r18,262144,424750,478,7710,9337,17525
FASTAI_19,NeuralNetFastAI_r19,131072,441667,483,7710,9342,17535
FASTAI_20,NeuralNetFastAI_r20,262144,427235,477,7710,9336,17523
FASTAI_21,NeuralNetFastAI_r21,131072,422411,482,7710,9341,17533
FASTAI_22,NeuralNetFastAI_r22,131072,444245,482,7710,9341,17533
FASTAI_23,NeuralNetFastAI_r23,0,340131,482,7710,9341,17533
FASTAI_24,NeuralNetFastAI_r24,0,340028,481,7710,9340,17531
FASTAI_25,NeuralNetFastAI_r25,131072,432021,482,7710,9341,17533
FASTAI_26,NeuralNetFastAI_r26,262144,454209,482,7710,9341,17533
FASTAI_27,NeuralNetFastAI_r27,131072,442438,483,7710,9342,17535
FASTAI_28,NeuralNetFastAI_r28,0,340404,480,7710,9339,17529
FASTAI_29,NeuralNetFastAI_r29,262144,348962,481,7710,9339,17530
FASTAI_30,NeuralNetFastAI_r30,262144,423480,482,7710,9341,17533
FASTAI_31,NeuralNetFastAI_r31,131072,404876,482,7710,9341,17533
FASTAI_32,NeuralNetFastAI_r32,131072,404394,481,7710,9340,17531
FASTAI_33,NeuralNetFastAI_r33,131072,460667,482,7710,9341,17533
FASTAI_34,NeuralNetFastAI_r34,262144,366613,482,7710,9340,17532
FASTAI_35,NeuralNetFastAI_r35,131072,369789,481,7710,9339,17530
FASTAI_36,NeuralNetFastAI_r36,131072,388430,477,7710,9336,17523
FASTAI_37,NeuralNetFastAI_r37,131072,432969,483,7710,9342,17535
FASTAI_38,NeuralNetFastAI_r38,0,321367,476,7710,9334,17520
FASTAI_39,NeuralNetFastAI_r39,393216,339120,482,7710,9341,17533
FASTAI_40,NeuralNetFastAI_r40,262144,365056,481,7710,9339,17530
FASTAI_41,NeuralNetFastAI_r41,262144,411394,480,7710,9339,17529
FASTAI_42,NeuralNetFastAI_r42,131072,442458,483,7710,9342,17535
FASTAI_43,NeuralNetFastAI_r43,131072,433265,483,7710,9342,17535
FASTAI_44,NeuralNetFastAI_r44,262144,340205,481,7710,9340,17531
FASTAI_45,NeuralNetFastAI_r45,0,319234,477,7710,9336,17523
FASTAI_46,NeuralNetFastAI_r46,131072,338163,481,7710,9340,17531
FASTAI_47,NeuralNetFastAI_r47,131072,340868,480,7710,9339,17529
FASTAI_48,NeuralNetFastAI_r48,131072,316576,478,7710,9337,17525
FASTAI_49,NeuralNetFastAI_r49,131072,428385,483,7710,9342,17535
FASTAI_50,NeuralNetFastAI_r50,131072,316947,477,7710,9336,17523
FASTAI_51,NeuralNetFastAI_r51,262144,451275,482,7710,9341,17533
FASTAI_52,NeuralNetFastAI_r52,131072,321970,477,7710,9335,17522
FASTAI_53,NeuralNetFastAI_r53,131072,416383,482,7710,9341,17533
FASTAI_54,NeuralNetFastAI_r54,131072,421609,481,7710,9340,17531
FASTAI_55,NeuralNetFastAI_r55,0,421619,482,7710,9341,17533
FASTAI_56,NeuralNetFastAI_r56,262144,317235,477,7710,9336,17523
FASTAI_57,NeuralNetFastAI_r57,131072,321976,477,7710,9335,17522
FASTAI_58,NeuralNetFastAI_r58,131072,445008,482,7710,9341,17533
FASTAI_59,NeuralNetFastAI_r59,131072,442631,483,7710,9342,17535
FASTAI_60,NeuralNetFastAI_r60,262144,324225,477,7710,9335,17522
FASTAI_61,NeuralNetFastAI_r61,0,327941,476,7710,9334,17520
FASTAI_62,NeuralNetFastAI_r62,131072,428441,483,7710,9342,17535
FASTAI_63,NeuralNetFastAI_r63,131072,413122,480,7710,9339,17529
FASTAI_64,NeuralNetFastAI_r64,0,435431,483,7710,9342,17535
FASTAI_65,NeuralNetFastAI_r65,524288,360333,478,7710,9337,17525
FASTAI_66,NeuralNetFastAI_r66,262144,403757,478,7710,9337,17525
FASTAI_67,NeuralNetFastAI_r67,0,431954,483,7710,9342,17535
FASTAI_68,NeuralNetFastAI_r68,0,403439,480,7710,9339,17529
FASTAI_69,NeuralNetFastAI_r69,131072,364015,481,7710,9339,17530
FASTAI_70,NeuralNetFastAI_r70,131072,429535,481,7710,9340,17531
FASTAI_71,NeuralNetFastAI_r71,131072,362222,483,7710,9342,17535
FASTAI_72,NeuralNetFastAI_r72,131072,401126,477,7710,9336,17523
FASTAI_73,NeuralNetFastAI_r73,131072,401504,477,7710,9336,17523
FASTAI_74,NeuralNetFastAI_r74,131072,428615,481,7710,9340,17531
FASTAI_75,NeuralNetFastAI_r75,393216,428393,478,7710,9337,17525
FASTAI_76,NeuralNetFastAI_r76,131072,320539,477,7710,9335,17522
FASTAI_77,NeuralNetFastAI_r77,131072,406032,480,7710,9339,17529
FASTAI_78,NeuralNetFastAI_r78,131072,425643,483,7710,9342,17535
FASTAI_79,NeuralNetFastAI_r79,131072,411348,481,7710,9340,17531
FASTAI_80,NeuralNetFastAI_r80,0,342488,479,7710,9337,17526
FASTAI_81,NeuralNetFastAI_r81,262144,454024,482,7710,9341,17533
FASTAI_82,NeuralNetFastAI_r82,0,413633,480,7710,9339,17529
FASTAI_83,NeuralNetFastAI_r83,0,357701,482,7710,9341,17533
FASTAI_84,NeuralNetFastAI_r84,262144,359231,482,7710,9341,17533
FASTAI_85,NeuralNetFastAI_r85,131072,411545,481,7710,9340,17531
FASTAI_86,NeuralNetFastAI_r86,131072,405190,482,7710,9341,17533
FASTAI_87,NeuralNetFastAI_r87,131072,364627,481,7710,9339,17530
FASTAI_88,NeuralNetFastAI_r88,262144,379252,478,7710,9337,17525
FASTAI_89,NeuralNetFastAI_r89,131072,357903,482,7710,9341,17533
FASTAI_90,NeuralNetFastAI_r90,131072,452837,483,7710,9342,17535
FASTAI_91,NeuralNetFastAI_r91,131072,400968,480,7710,9339,17529
FASTAI_92,NeuralNetFastAI_r92,131072,385250,478,7710,9337,17525
FASTAI_93,NeuralNetFastAI_r93,131072,407652,480,7710,9339,17529
FASTAI_94,NeuralNetFastAI_r94,131072,439692,482,7710,9341,17533
FASTAI_95,NeuralNetFastAI_r95,131072,364107,482,7710,9340,17532
FASTAI_96,NeuralNetFastAI_r96,0,422762,483,7710,9342,17535
FASTAI_97,NeuralNetFastAI_r97,131072,337602,480,7710,9339,17529
FASTAI_98,NeuralNetFastAI_r98,131072,403518,477,7710,9336,17523
FASTAI_99,NeuralNetFastAI_r99,262144,431964,481,7710,9340,17531
FASTAI_100,NeuralNetFastAI_r100,131072,404252,483,7710,9345,17538
FASTAI_101,NeuralNetFastAI_r101,131072,404963,483,7710,9345,17538
FASTAI_102,NeuralNetFastAI_r102,131072,404467,481,7710,9343,17534
FASTAI_103,NeuralNetFastAI_r103,131072,337965,482,7710,9344,17536
FASTAI_104,NeuralNetFastAI_r104,0,417768,481,7710,9343,17534
FASTAI_105,NeuralNetFastAI_r105,131072,410784,482,7710,9344,17536
FASTAI_106,NeuralNetFastAI_r106,393216,339220,482,7710,9344,17536
FASTAI_107,NeuralNetFastAI_r107,0,401640,483,7710,9345,17538
FASTAI_108,NeuralNetFastAI_r108,131072,361854,483,7710,9344,17537
FASTAI_109,NeuralNetFastAI_r109,131072,374184,483,7710,9344,17537
FASTAI_110,NeuralNetFastAI_r110,131072,404677,483,7710,9345,17538
FASTAI_111,NeuralNetFastAI_r111,131072,402009,482,7710,9344,17536
FASTAI_112,NeuralNetFastAI_r112,0,359439,479,7710,9341,17530
FASTAI_113,NeuralNetFastAI_r113,131072,320792,477,7710,9338,17525
FASTAI_114,NeuralNetFastAI_r114,131072,359823,478,7710,9340,17528
FASTAI_115,NeuralNetFastAI_r115,262144,403988,481,7710,9343,17534
FASTAI_116,NeuralNetFastAI_r116,262144,427817,483,7710,9345,17538
FASTAI_117,NeuralNetFastAI_r117,262144,410404,483,7710,9345,17538
FASTAI_118,NeuralNetFastAI_r118,131072,411563,482,7710,9344,17536
FASTAI_119,NeuralNetFastAI_r119,0,461671,484,7710,9346,17540
FASTAI_120,NeuralNetFastAI_r120,262144,361339,483,7710,9344,17537
FASTAI_121,NeuralNetFastAI_r121,131072,413002,482,7710,9344,17536
FASTAI_122,NeuralNetFastAI_r122,131072,423417,482,7710,9344,17536
FASTAI_123,NeuralNetFastAI_r123,0,441147,482,7710,9344,17536
FASTAI_124,NeuralNetFastAI_r124,262144,411029,482,7710,9344,17536
FASTAI_125,NeuralNetFastAI_r125,131072,445076,483,7710,9345,17538
FASTAI_126,NeuralNetFastAI_r126,0,338743,483,7710,9345,17538
FASTAI_127,NeuralNetFastAI_r127,262144,404260,481,7710,9343,17534
FASTAI_128,NeuralNetFastAI_r128,131072,341870,480,7710,9341,17531
FASTAI_129,NeuralNetFastAI_r129,131072,361422,483,7710,9345,17538
FASTAI_130,NeuralNetFastAI_r130,131072,339977,481,7710,9343,17534
FASTAI_131,NeuralNetFastAI_r131,262144,342749,481,7710,9342,17533
FASTAI_132,NeuralNetFastAI_r132,131072,415163,481,7710,9343,17534
FASTAI_133,NeuralNetFastAI_r133,0,364009,483,7710,9345,17538
FASTAI_134,NeuralNetFastAI_r134,0,404410,483,7710,9345,17538
FASTAI_135,NeuralNetFastAI_r135,0,340276,481,7710,9343,17534
FASTAI_136,NeuralNetFastAI_r136,262144,338304,482,7710,9344,17536
FASTAI_137,NeuralNetFastAI_r137,131072,342350,480,7710,9341,17531
FASTAI_138,NeuralNetFastAI_r138,131072,345406,482,7710,9343,17535
FASTAI_139,NeuralNetFastAI_r139,131072,423590,484,7710,9346,17540
FASTAI_140,NeuralNetFastAI_r140,131072,365187,483,7710,9344,17537
FASTAI_141,NeuralNetFastAI_r141,131072,411478,482,7710,9344,17536
FASTAI_142,NeuralNetFastAI_r142,0,436991,484,7710,9346,17540
FASTAI_143,NeuralNetFastAI_r143,131072,425045,483,7710,9345,17538
FASTAI_144,NeuralNetFastAI_r144,393216,416066,483,7710,9345,17538
FASTAI_145,NeuralNetFastAI_r145,262144,365577,483,7710,9344,17537
FASTAI_146,NeuralNetFastAI_r146,131072,414705,483,7710,9345,17538
FASTAI_147,NeuralNetFastAI_r147,131072,323048,477,7710,9338,17525
FASTAI_148,NeuralNetFastAI_r148,131072,413110,482,7710,9344,17536
FASTAI_149,NeuralNetFastAI_r149,393216,424054,481,7710,9343,17534
FASTAI_150,NeuralNetFastAI_r150,131072,413511,482,7710,9344,17536
FASTAI_151,NeuralNetFastAI_r151,131072,316179,479,7710,9341,17530
FASTAI_152,NeuralNetFastAI_r152,131072,395045,483,7710,9345,17538
FASTAI_153,NeuralNetFastAI_r153,0,404099,483,7710,9345,17538
FASTAI_154,NeuralNetFastAI_r154,131072,338027,482,7710,9344,17536
FASTAI_155,NeuralNetFastAI_r155,131072,337613,481,7710,9343,17534
FASTAI_156,NeuralNetFastAI_r156,131072,401404,479,7710,9341,17530
FASTAI_157,NeuralNetFastAI_r157,131072,430873,483,7710,9345,17538
FASTAI_158,NeuralNetFastAI_r158,131072,434947,484,7710,9346,17540
FASTAI_159,NeuralNetFastAI_r159,0,322719,477,7710,9338,17525
FASTAI_160,NeuralNetFastAI_r160,131072,363856,483,7710,9344,17537
FASTAI_161,NeuralNetFastAI_r161,262144,465330,483,7710,9345,17538
FASTAI_162,NeuralNetFastAI_r162,0,403494,482,7710,9344,17536
FASTAI_163,NeuralNetFastAI_r163,131072,431951,484,7710,9346,17540
FASTAI_164,NeuralNetFastAI_r164,131072,422713,482,7710,9344,17536
FASTAI_165,NeuralNetFastAI_r165,131072,361155,483,7710,9345,17538
FASTAI_166,NeuralNetFastAI_r166,131072,320188,478,7710,9339,17527
FASTAI_167,NeuralNetFastAI_r167,0,413695,483,7710,9345,17538
FASTAI_168,NeuralNetFastAI_r168,131072,439156,484,7710,9346,17540
FASTAI_169,NeuralNetFastAI_r169,0,423758,484,7710,9346,17540
FASTAI_170,NeuralNetFastAI_r170,131072,342623,483,7710,9345,17538
FASTAI_171,NeuralNetFastAI_r171,131072,340157,483,7710,9345,17538
FASTAI_172,NeuralNetFastAI_r172,131072,392051,479,7710,9341,17530
FASTAI_173,NeuralNetFastAI_r173,262144,361602,482,7710,9343,17535
FASTAI_174,NeuralNetFastAI_r174,0,316746,479,7710,9341,17530
FASTAI_175,NeuralNetFastAI_r175,131072,442043,483,7710,9345,17538
FASTAI_176,NeuralNetFastAI_r176,131072,404852,482,7710,9344,17536
FASTAI_177,NeuralNetFastAI_r177,131072,336935,482,7710,9344,17536
FASTAI_178,NeuralNetFastAI_r178,0,403566,481,7710,9343,17534
FASTAI_179,NeuralNetFastAI_r179,131072,400380,478,7710,9340,17528
FASTAI_180,NeuralNetFastAI_r180,0,343222,481,7710,9342,17533
FASTAI_181,NeuralNetFastAI_r181,131072,321943,478,7710,9339,17527
FASTAI_182,NeuralNetFastAI_r182,131072,412959,481,7710,9343,17534
FASTAI_183,NeuralNetFastAI_r183,131072,429397,483,7710,9345,17538
FASTAI_184,NeuralNetFastAI_r184,0,426043,483,7710,9345,17538
FASTAI_185,NeuralNetFastAI_r185,0,361936,483,7710,9345,17538
FASTAI_186,NeuralNetFastAI_r186,0,344599,480,7710,9341,17531
FASTAI_187,NeuralNetFastAI_r187,262144,460799,483,7710,9345,17538
FASTAI_188,NeuralNetFastAI_r188,0,340197,482,7710,9344,17536
FASTAI_189,NeuralNetFastAI_r189,131072,400181,478,7710,9340,17528
FASTAI_190,NeuralNetFastAI_r190,131072,413998,483,7710,9345,17538
FASTAI_191,NeuralNetFastAI_r191,131072,339913,483,7710,9345,17538
FASTAI_192,NeuralNetFastAI_r192,131072,422876,482,7710,9344,17536
FASTAI_193,NeuralNetFastAI_r193,131072,341079,480,7710,9341,17531
FASTAI_194,NeuralNetFastAI_r194,262144,359901,484,7710,9346,17540
FASTAI_195,NeuralNetFastAI_r195,131072,321525,478,7710,9339,17527
FASTAI_196,NeuralNetFastAI_r196,262144,394393,482,7710,9344,17536
FASTAI_197,NeuralNetFastAI_r197,131072,338968,482,7710,9344,17536
FASTAI_198,NeuralNetFastAI_r198,131072,338341,481,7710,9343,17534
FASTAI_199,NeuralNetFastAI_r199,0,407257,483,7710,9345,17538
FASTAI_200,NeuralNetFastAI_r200,131072,371159,483,7710,9344,17537
CAT_0,CatBoost_c1,0,232279,391,7710,65793,73894
CAT_1,CatBoost_r1,0,561927,520,7722,434746,442988
CAT_2,CatBoost_r2,0,199109,520,7710,48489,56719
CAT_3,CatBoost_r3,0,210888,524,7710,54333,62567
CAT_4,CatBoost_r4,0,197839,520,7710,47849,56079
CAT_5,CatBoost_r5,262144,196362,524,7722,47101,55347
CAT_6,CatBoost_r6,143360,203482,520,7710,50649,58879
CAT_7,CatBoost_r7,0,216275,524,7710,57077,65311
CAT_8,CatBoost_r8,131072,199035,524,7722,48445,56691
CAT_9,CatBoost_r9,262144,263063,520,7710,136074,144304
CAT_10,CatBoost_r10,131072,197883,521,7710,47877,56108
CAT_11,CatBoost_r11,323584,199417,525,7710,48625,56860
CAT_12,CatBoost_r12,192512,229912,525,7710,63865,72100
CAT_13,CatBoost_r13,131072,210522,525,7722,54177,62424
CAT_14,CatBoost_r14,131072,225163,521,7710,61517,69748
CAT_15,CatBoost_r15,0,197520,521,7710,47669,55900
CAT_16,CatBoost_r16,0,196793,525,7710,47313,55548
CAT_17,CatBoost_r17,393216,246702,521,7722,120286,128529
CAT_18,CatBoost_r18,0,216712,525,7710,57265,65500
CAT_19,CatBoost_r19,0,324897,525,7710,197674,205909
CAT_20,CatBoost_r20,282624,198952,525,7710,48385,56620
CAT_21,CatBoost_r21,0,196918,525,7722,47361,55608
CAT_22,CatBoost_r22,266240,199485,525,7710,48649,56884
CAT_23,CatBoost_r23,0,199658,525,7722,48721,56968
CAT_24,CatBoost_r24,131072,202032,521,7710,49949,58180
CAT_25,CatBoost_r25,262144,199667,525,7710,48745,56980
CAT_26,CatBoost_r26,131072,199517,525,7710,48641,56876
CAT_27,CatBoost_r27,131072,217327,525,7722,57553,65800
CAT_28,CatBoost_r28,135168,217280,521,7710,57549,65780
CAT_29,CatBoost_r29,282624,199704,525,7710,48761,56996
CAT_30,CatBoost_r30,131072,199304,525,7710,48537,56772
CAT_31,CatBoost_r31,131072,211355,525,7722,54601,62848
CAT_32,CatBoost_r32,0,211453,525,7710,54609,62844
CAT_33,CatBoost_r33,0,216183,525,7710,56969,65204
CAT_34,CatBoost_r34,131072,199699,525,7710,48761,56996
CAT_35,CatBoost_r35,135168,216989,521,7722,57437,65680
CAT_36,CatBoost_r36,0,197754,521,7710,47781,56012
CAT_37,CatBoost_r37,131072,197787,525,7722,47817,56064
CAT_38,CatBoost_r38,0,198718,525,7710,48273,56508
CAT_39,CatBoost_r39,159744,217827,525,7710,57849,66084
CAT_40,CatBoost_r40,131072,212760,521,7722,85694,93937
CAT_41,CatBoost_r41,151552,198072,525,7710,47945,56180
CAT_42,CatBoost_r42,0,196127,525,7710,47009,55244
CAT_43,CatBoost_r43,0,214717,521,7722,87774,96017
CAT_44,CatBoost_r44,0,201397,521,7710,49605,57836
CAT_45,CatBoost_r45,0,210666,525,7710,54257,62492
CAT_46,CatBoost_r46,0,197007,521,7722,47485,55728
CAT_47,CatBoost_r47,0,206080,521,7710,79382,87613
CAT_48,CatBoost_r48,282624,198780,525,7710,48265,56500
CAT_49,CatBoost_r49,131072,196318,525,7710,47097,55332
CAT_50,CatBoost_r50,131072,216089,521,7722,56973,65216
CAT_51,CatBoost_r51,274432,203392,521,7710,50605,58836
CAT_52,CatBoost_r52,131072,211235,525,7710,54553,62788
CAT_53,CatBoost_r53,139264,214360,521,7722,56101,64344
CAT_54,CatBoost_r54,135168,217807,521,7710,57829,66060
CAT_55,CatBoost_r55,0,210848,521,7710,54357,62588
CAT_56,CatBoost_r56,0,201834,521,7710,49821,58052
CAT_57,CatBoost_r57,131072,217418,521,7710,90086,98317
CAT_58,CatBoost_r58,0,217808,525,7722,90626,98873
CAT_59,CatBoost_r59,0,215465,521,7710,88414,96645
CAT_60,CatBoost_r60,131072,198094,525,7710,47961,56196
CAT_61,CatBoost_r61,131072,196893,525,7722,47409,55656
CAT_62,CatBoost_r62,0,210777,525,7710,54305,62540
CAT_63,CatBoost_r63,147456,199236,521,7710,48517,56748
CAT_64,CatBoost_r64,131072,286860,525,7710,159706,167941
CAT_65,CatBoost_r65,0,212690,521,7722,55261,63504
CAT_66,CatBoost_r66,184320,199195,521,7710,48533,56764
CAT_67,CatBoost_r67,192512,269056,521,7710,141966,150197
CAT_68,CatBoost_r68,147456,235571,525,7710,66697,74932
CAT_69,CatBoost_r69,262144,200371,525,7710,49097,57332
CAT_70,CatBoost_r70,274432,198943,521,7722,48453,56696
CAT_71,CatBoost_r71,131072,208659,521,7710,81494,89725
CAT_72,CatBoost_r72,131072,199122,525,7710,48441,56676
CAT_73,CatBoost_r73,131072,197312,521,7710,47589,55820
CAT_74,CatBoost_r74,131072,571690,521,7710,444950,453181
CAT_75,CatBoost_r75,0,201914,521,7710,49861,58092
CAT_76,CatBoost_r76,2166784,374348,525,7710,247474,255709
CAT_77,CatBoost_r77,131072,229372,525,7710,63561,71796
CAT_78,CatBoost_r78,0,198402,525,7710,48105,56340
CAT_79,CatBoost_r79,159744,199051,525,7722,48449,56696
CAT_80,CatBoost_r80,131072,222051,525,7710,59937,68172
CAT_81,CatBoost_r81,151552,216879,521,7710,57365,65596
CAT_82,CatBoost_r82,143360,198823,525,7710,48289,56524
CAT_83,CatBoost_r83,0,196504,525,7710,47161,55396
CAT_84,CatBoost_r84,0,196688,525,7722,47241,55488
CAT_85,CatBoost_r85,180224,201110,525,7710,73954,82189
CAT_86,CatBoost_r86,151552,210653,525,7710,54209,62444
CAT_87,CatBoost_r87,0,201507,521,7722,49701,57944
CAT_88,CatBoost_r88,0,315995,521,7710,188958,197189
CAT_89,CatBoost_r89,0,199144,525,7710,48457,56692
CAT_90,CatBoost_r90,131072,211223,521,7722,54549,62792
CAT_91,CatBoost_r91,147456,199801,525,7710,48817,57052
CAT_92,CatBoost_r92,0,1229499,521,7710,1102399,1110630
CAT_93,CatBoost_r93,323584,199317,521,7710,48565,56796
CAT_94,CatBoost_r94,0,197110,521,7710,47493,55724
CAT_95,CatBoost_r95,159744,206200,521,7722,52021,60264
CAT_96,CatBoost_r96,0,198765,525,7710,48265,56500
CAT_97,CatBoost_r97,135168,196371,525,7710,47073,55308
CAT_98,CatBoost_r98,131072,199584,525,7722,48689,56936
CAT_99,CatBoost_r99,131072,242848,525,7710,116266,124501
CAT_100,CatBoost_r100,0,199497,522,7722,48697,56941
CAT_101,CatBoost_r101,131072,212507,522,7710,55161,63393
CAT_102,CatBoost_r102,131072,199081,526,7710,48453,56689
CAT_103,CatBoost_r103,0,235694,526,7710,66733,74969
CAT_104,CatBoost_r104,131072,220278,522,7710,59049,67281
CAT_105,CatBoost_r105,192512,212088,526,7710,54925,63161
CAT_106,CatBoost_r106,278528,210801,526,7722,54325,62573
CAT_107,CatBoost_r107,0,211444,526,7710,54637,62873
CAT_108,CatBoost_r108,0,217366,522,7710,57617,65849
CAT_109,CatBoost_r109,282624,199124,526,7710,48477,56713
CAT_110,CatBoost_r110,0,210784,526,7722,54285,62533
CAT_111,CatBoost_r111,131072,211017,526,7710,54421,62657
CAT_112,CatBoost_r112,0,234718,526,7710,66245,74481
CAT_113,CatBoost_r113,135168,198895,526,7710,48341,56577
CAT_114,CatBoost_r114,262144,199125,526,7722,48453,56701
CAT_115,CatBoost_r115,0,280173,522,7710,153482,161714
CAT_116,CatBoost_r116,323584,198653,526,7710,48205,56441
CAT_117,CatBoost_r117,0,213777,522,7710,55825,64057
CAT_118,CatBoost_r118,131072,265367,522,7710,138442,146674
CAT_119,CatBoost_r119,0,210771,526,7710,54269,62505
CAT_120,CatBoost_r120,0,198537,526,7710,48157,56393
CAT_121,CatBoost_r121,131072,196133,526,7710,47013,55249
CAT_122,CatBoost_r122,0,206675,522,7722,52257,60501
CAT_123,CatBoost_r123,0,223580,522,7710,60729,68961
CAT_124,CatBoost_r124,0,211043,526,7710,54405,62641
CAT_125,CatBoost_r125,0,220268,522,7710,59073,67305
CAT_126,CatBoost_r126,131072,199806,526,7710,48789,57025
CAT_127,CatBoost_r127,2134016,374314,526,7710,247678,255914
CAT_128,CatBoost_r128,0,216742,522,7710,57305,65537
CAT_129,CatBoost_r129,147456,200027,522,7710,48921,57153
CAT_130,CatBoost_r130,266240,198582,522,7710,48201,56433
CAT_131,CatBoost_r131,0,202225,522,7710,50025,58257
CAT_132,CatBoost_r132,131072,199339,522,7710,48577,56809
CAT_133,CatBoost_r133,131072,215693,526,7722,88678,96926
CAT_134,CatBoost_r134,131072,308391,522,7710,181930,190162
CAT_135,CatBoost_r135,131072,236820,526,7710,109598,117834
CAT_136,CatBoost_r136,0,198951,526,7722,48429,56677
CAT_137,CatBoost_r137,192512,206132,526,7710,51957,60193
CAT_138,CatBoost_r138,143360,235670,526,7722,66757,75005
CAT_139,CatBoost_r139,135168,196494,526,7710,47133,55369
CAT_140,CatBoost_r140,0,210625,522,7710,54249,62481
CAT_141,CatBoost_r141,0,199636,526,7710,48733,56969
CAT_142,CatBoost_r142,131072,208068,522,7722,52961,61205
CAT_143,CatBoost_r143,131072,206490,526,7710,79454,87690
CAT_144,CatBoost_r144,0,216725,522,7710,57265,65497
CAT_145,CatBoost_r145,671744,312898,522,7710,186098,194330
CAT_146,CatBoost_r146,131072,210472,526,7710,54117,62353
CAT_147,CatBoost_r147,0,210817,526,7722,54333,62581
CAT_148,CatBoost_r148,0,201653,526,7710,74798,83034
CAT_149,CatBoost_r149,131072,218877,526,7710,58317,66553
CAT_150,CatBoost_r150,0,199254,522,7710,48537,56769
CAT_151,CatBoost_r151,0,205660,526,7710,79254,87490
CAT_152,CatBoost_r152,0,211300,522,7722,54625,62869
CAT_153,CatBoost_r153,0,220006,522,7710,58913,67145
CAT_154,CatBoost_r154,0,201521,522,7710,49697,57929
CAT_155,CatBoost_r155,131072,217427,526,7710,57621,65857
CAT_156,CatBoost_r156,131072,208065,522,7710,52945,61177
CAT_157,CatBoost_r157,0,347954,522,7722,220898,229142
CAT_158,CatBoost_r158,131072,205478,522,7710,51673,59905
CAT_159,CatBoost_r159,0,201862,522,7710,49841,58073
CAT_160,CatBoost_r160,151552,212204,522,7710,84986,93218
CAT_161,CatBoost_r161,151552,249403,522,7710,122762,130994
CAT_162,CatBoost_r162,131072,255997,522,7710,128890,137122
CAT_163,CatBoost_r163,262144,218848,526,7710,58373,66609
CAT_164,CatBoost_r164,131072,197584,526,7710,47717,55953
CAT_165,CatBoost_r165,131072,220131,522,7722,58985,67229
CAT_166,CatBoost_r166,0,197240,526,7710,47501,55737
CAT_167,CatBoost_r167,0,242999,526,7722,70429,78677
CAT_168,CatBoost_r168,143360,207009,522,7710,52465,60697
CAT_169,CatBoost_r169,0,198739,526,7710,48253,56489
CAT_170,CatBoost_r170,0,212122,526,7710,55005,63241
CAT_171,CatBoost_r171,143360,198750,526,7710,48261,56497
CAT_172,CatBoost_r172,0,283139,522,7710,156498,164730
CAT_173,CatBoost_r173,0,221539,526,7710,59653,67889
CAT_174,CatBoost_r174,0,205833,522,7722,78586,86830
CAT_175,CatBoost_r175,0,240999,522,7710,69465,77697
CAT_176,CatBoost_r176,0,197255,522,7710,47569,55801
CAT_177,CatBoost_r177,0,196163,526,7710,46965,55201
CAT_178,CatBoost_r178,131072,217259,526,7722,57525,65773
CAT_179,CatBoost_r179,143360,198664,526,7710,48213,56449
CAT_180,CatBoost_r180,278528,220742,522,7710,59305,67537
CAT_181,CatBoost_r181,0,284336,522,7710,157362,165594
CAT_182,CatBoost_r182,282624,198824,526,7710,48293,56529
CAT_183,CatBoost_r183,131072,198186,526,7710,48013,56249
CAT_184,CatBoost_r184,0,205471,522,7722,51689,59933
CAT_185,CatBoost_r185,0,245130,526,7710,71485,79721
CAT_186,CatBoost_r186,151552,207325,522,7710,80354,88586
CAT_187,CatBoost_r187,282624,211202,522,7710,84810,93042
CAT_188,CatBoost_r188,0,230508,526,7722,64181,72429
CAT_189,CatBoost_r189,0,198028,522,7710,47953,56185
CAT_190,CatBoost_r190,0,210660,526,7710,54245,62481
CAT_191,CatBoost_r191,0,217454,526,7710,57637,65873
CAT_192,CatBoost_r192,131072,222069,526,7722,59925,68173
CAT_193,CatBoost_r193,131072,197386,526,7710,47589,55825
CAT_194,CatBoost_r194,0,203755,522,7710,50809,59041
CAT_195,CatBoost_r195,151552,213798,522,7710,55809,64041
CAT_196,CatBoost_r196,192512,198944,522,7710,48377,56609
CAT_197,CatBoost_r197,131072,199980,526,7722,48917,57165
CAT_198,CatBoost_r198,278528,196516,526,7710,47149,55385
CAT_199,CatBoost_r199,131072,198713,526,7710,48245,56481
CAT_200,CatBoost_r200,0,203156,522,7722,50529,58773
