Model_ID,Model,Memory,Predictor_Size,Learner_Size,Models_Size,Total_Size
XT_0,ExtraTrees_c1,574481,387,6651,1511273,1518311
XT_1,ExtraTrees_r1,223703,456,6651,256891,263998
XT_2,ExtraTrees_r2,147363,454,6651,487297,494402
XT_3,ExtraTrees_r3,117163,454,6651,646757,653862
XT_4,ExtraTrees_r4,117795,456,6651,171345,178452
XT_5,ExtraTrees_r5,128266,454,6651,970817,977922
XT_6,ExtraTrees_r6,116567,454,6651,222254,229359
XT_7,ExtraTrees_r7,105235,454,6651,124100,131205
XT_8,ExtraTrees_r8,105281,454,6651,487297,494402
XT_9,ExtraTrees_r9,105556,454,6651,222254,229359
XT_10,ExtraTrees_r10,108432,455,6651,124104,131210
XT_11,ExtraTrees_r11,112410,455,6651,487301,494407
XT_12,ExtraTrees_r12,105940,457,6651,126220,133328
XT_13,ExtraTrees_r13,113666,455,6651,1511373,1518479
XT_14,ExtraTrees_r14,105159,457,6651,126220,133328
XT_15,ExtraTrees_r15,108584,457,6651,698981,706089
XT_16,ExtraTrees_r16,108014,457,6651,1122235,1129343
XT_17,ExtraTrees_r17,108309,457,6651,256895,264003
XT_18,ExtraTrees_r18,114932,455,6651,970821,977927
XT_19,ExtraTrees_r19,122283,457,6651,927168,934276
XT_20,ExtraTrees_r20,107218,455,6651,487301,494407
XT_21,ExtraTrees_r21,121541,457,6651,698981,706089
XT_22,ExtraTrees_r22,129675,457,6651,443113,450221
XT_23,ExtraTrees_r23,113886,457,6651,168949,176057
XT_24,ExtraTrees_r24,115491,457,6651,453220,460328
XT_25,ExtraTrees_r25,120227,457,6651,443113,450221
XT_26,ExtraTrees_r26,117549,455,6651,392409,399515
XT_27,ExtraTrees_r27,98854,457,6651,126220,133328
XT_28,ExtraTrees_r28,543455,455,6651,487301,494407
XT_29,ExtraTrees_r29,161159,455,6651,222258,229364
XT_30,ExtraTrees_r30,139885,455,6651,392409,399515
XT_31,ExtraTrees_r31,126323,457,6651,531073,538181
XT_32,ExtraTrees_r32,120599,457,6651,1322422,1329530
XT_33,ExtraTrees_r33,138095,455,6651,646761,653867
XT_34,ExtraTrees_r34,124951,457,6651,126220,133328
XT_35,ExtraTrees_r35,123424,457,6651,698981,706089
XT_36,ExtraTrees_r36,140271,457,6651,541581,548689
XT_37,ExtraTrees_r37,101957,457,6651,531073,538181
XT_38,ExtraTrees_r38,106415,457,6651,702021,709129
XT_39,ExtraTrees_r39,105785,457,6651,952137,959245
XT_40,ExtraTrees_r40,102139,457,6651,171349,178457
XT_41,ExtraTrees_r41,102421,457,6651,698981,706089
XT_42,ExtraTrees_r42,105011,457,6651,1207693,1214801
XT_43,ExtraTrees_r43,100678,455,6651,487301,494407
XT_44,ExtraTrees_r44,95821,457,6651,126220,133328
XT_45,ExtraTrees_r45,114372,455,6651,646761,653867
XT_46,ExtraTrees_r46,113999,457,6651,698981,706089
XT_47,ExtraTrees_r47,95610,457,6651,126220,133328
XT_48,ExtraTrees_r48,106967,457,6651,698981,706089
XT_49,ExtraTrees_r49,116203,455,6651,1511373,1518479
XT_50,ExtraTrees_r50,126816,457,6651,171349,178457
XT_51,ExtraTrees_r51,129215,455,6651,124104,131210
XT_52,ExtraTrees_r52,109068,455,6651,222258,229364
XT_53,ExtraTrees_r53,132011,455,6651,152593,159699
XT_54,ExtraTrees_r54,141487,457,6651,126220,133328
XT_55,ExtraTrees_r55,146975,455,6651,152593,159699
XT_56,ExtraTrees_r56,124643,455,6651,646761,653867
XT_57,ExtraTrees_r57,122447,455,6651,152593,159699
XT_58,ExtraTrees_r58,122623,455,6651,124104,131210
XT_59,ExtraTrees_r59,128799,455,6651,646761,653867
XT_60,ExtraTrees_r60,536335,457,6651,168949,176057
XT_61,ExtraTrees_r61,151515,457,6651,250643,257751
XT_62,ExtraTrees_r62,122813,457,6651,126220,133328
XT_63,ExtraTrees_r63,125312,457,6651,171349,178457
XT_64,ExtraTrees_r64,130796,457,6651,126220,133328
XT_65,ExtraTrees_r65,120751,457,6651,126220,133328
XT_66,ExtraTrees_r66,114327,457,6651,443113,450221
XT_67,ExtraTrees_r67,113199,457,6651,126220,133328
XT_68,ExtraTrees_r68,102931,455,6651,124104,131210
XT_69,ExtraTrees_r69,104479,457,6651,698981,706089
XT_70,ExtraTrees_r70,113903,457,6651,126220,133328
XT_71,ExtraTrees_r71,111000,455,6651,646761,653867
XT_72,ExtraTrees_r72,104270,455,6651,222258,229364
XT_73,ExtraTrees_r73,103127,455,6651,392409,399515
XT_74,ExtraTrees_r74,101773,455,6651,222258,229364
XT_75,ExtraTrees_r75,116311,455,6651,124104,131210
XT_76,ExtraTrees_r76,104467,455,6651,487301,494407
XT_77,ExtraTrees_r77,96720,455,6651,124104,131210
XT_78,ExtraTrees_r78,129719,457,6651,1122235,1129343
XT_79,ExtraTrees_r79,124695,455,6651,124104,131210
XT_80,ExtraTrees_r80,109953,457,6651,702021,709129
XT_81,ExtraTrees_r81,141871,455,6651,970821,977927
XT_82,ExtraTrees_r82,114751,457,6651,702021,709129
XT_83,ExtraTrees_r83,124093,457,6651,256895,264003
XT_84,ExtraTrees_r84,118180,457,6651,242447,249555
XT_85,ExtraTrees_r85,138116,457,6651,952137,959245
XT_86,ExtraTrees_r86,130039,457,6651,531073,538181
XT_87,ExtraTrees_r87,102600,455,6651,222258,229364
XT_88,ExtraTrees_r88,103135,455,6651,646761,653867
XT_89,ExtraTrees_r89,97208,455,6651,970821,977927
XT_90,ExtraTrees_r90,105231,455,6651,152593,159699
XT_91,ExtraTrees_r91,101150,455,6651,392409,399515
XT_92,ExtraTrees_r92,94611,455,6651,487301,494407
XT_93,ExtraTrees_r93,475097,457,6651,126220,133328
XT_94,ExtraTrees_r94,126283,455,6651,124104,131210
XT_95,ExtraTrees_r95,133981,457,6651,426905,434013
XT_96,ExtraTrees_r96,133807,455,6651,392409,399515
XT_97,ExtraTrees_r97,108388,455,6651,152593,159699
XT_98,ExtraTrees_r98,117691,457,6651,702021,709129
XT_99,ExtraTrees_r99,111011,457,6651,553466,560574
XT_100,ExtraTrees_r100,102937,456,6651,222262,229369
XT_101,ExtraTrees_r101,105139,456,6651,222262,229369
XT_102,ExtraTrees_r102,106765,458,6651,126224,133333
XT_103,ExtraTrees_r103,116281,458,6651,453224,460333
XT_104,ExtraTrees_r104,112743,456,6651,487305,494412
XT_105,ExtraTrees_r105,116225,458,6651,698985,706094
XT_106,ExtraTrees_r106,113375,458,6651,126224,133333
XT_107,ExtraTrees_r107,132749,458,6651,126224,133333
XT_108,ExtraTrees_r108,120021,456,6651,222262,229369
XT_109,ExtraTrees_r109,116053,456,6651,1511377,1518484
XT_110,ExtraTrees_r110,124897,458,6651,531077,538186
XT_111,ExtraTrees_r111,109451,458,6651,162553,169662
XT_112,ExtraTrees_r112,107786,456,6651,1511377,1518484
XT_113,ExtraTrees_r113,98309,456,6651,124108,131215
XT_114,ExtraTrees_r114,110945,458,6651,952141,959250
XT_115,ExtraTrees_r115,125229,458,6651,702025,709134
XT_116,ExtraTrees_r116,115803,458,6651,126224,133333
XT_117,ExtraTrees_r117,123225,456,6651,392413,399520
XT_118,ExtraTrees_r118,106329,458,6651,126224,133333
XT_119,ExtraTrees_r119,103527,456,6651,970825,977932
XT_120,ExtraTrees_r120,117901,456,6651,970825,977932
XT_121,ExtraTrees_r121,109686,458,6651,126224,133333
XT_122,ExtraTrees_r122,105497,458,6651,168953,176062
XT_123,ExtraTrees_r123,113709,456,6651,152597,159704
XT_124,ExtraTrees_r124,463257,456,6651,124108,131215
XT_125,ExtraTrees_r125,128697,458,6651,453224,460333
XT_126,ExtraTrees_r126,122913,456,6651,970825,977932
XT_127,ExtraTrees_r127,117674,458,6651,453224,460333
XT_128,ExtraTrees_r128,107501,456,6651,124108,131215
XT_129,ExtraTrees_r129,104953,458,6651,443117,450226
XT_130,ExtraTrees_r130,113035,456,6651,487305,494412
XT_131,ExtraTrees_r131,144893,458,6651,698985,706094
XT_132,ExtraTrees_r132,140897,456,6651,646765,653872
XT_133,ExtraTrees_r133,143529,456,6651,392413,399520
XT_134,ExtraTrees_r134,138877,458,6651,1322426,1329535
XT_135,ExtraTrees_r135,153773,456,6651,392413,399520
XT_136,ExtraTrees_r136,163009,458,6651,126224,133333
XT_137,ExtraTrees_r137,169549,458,6651,453224,460333
XT_138,ExtraTrees_r138,157177,458,6651,126224,133333
XT_139,ExtraTrees_r139,163457,458,6651,250647,257756
XT_140,ExtraTrees_r140,164153,456,6651,124108,131215
XT_141,ExtraTrees_r141,157277,458,6651,553470,560579
XT_142,ExtraTrees_r142,163413,458,6651,553470,560579
XT_143,ExtraTrees_r143,154781,456,6651,487305,494412
XT_144,ExtraTrees_r144,144233,458,6651,1122239,1129348
XT_145,ExtraTrees_r145,137223,456,6651,152597,159704
XT_146,ExtraTrees_r146,134193,456,6651,487305,494412
XT_147,ExtraTrees_r147,129869,458,6651,126224,133333
XT_148,ExtraTrees_r148,110129,456,6651,1511377,1518484
XT_149,ExtraTrees_r149,113337,458,6651,952141,959250
XT_150,ExtraTrees_r150,102551,458,6651,702025,709134
XT_151,ExtraTrees_r151,103809,456,6651,970825,977932
XT_152,ExtraTrees_r152,105509,458,6651,443117,450226
XT_153,ExtraTrees_r153,91571,456,6651,392413,399520
XT_154,ExtraTrees_r154,96217,456,6651,392413,399520
XT_155,ExtraTrees_r155,97777,456,6651,124108,131215
XT_156,ExtraTrees_r156,407735,458,6651,126224,133333
XT_157,ExtraTrees_r157,166959,458,6651,692265,699374
XT_158,ExtraTrees_r158,133161,458,6651,1322426,1329535
XT_159,ExtraTrees_r159,109873,458,6651,126224,133333
XT_160,ExtraTrees_r160,102231,456,6651,222262,229369
XT_161,ExtraTrees_r161,104037,458,6651,126224,133333
XT_162,ExtraTrees_r162,121553,458,6651,702025,709134
XT_163,ExtraTrees_r163,102253,458,6651,242451,249560
XT_164,ExtraTrees_r164,110801,458,6651,443117,450226
XT_165,ExtraTrees_r165,106863,458,6651,692265,699374
XT_166,ExtraTrees_r166,113245,456,6651,1511377,1518484
XT_167,ExtraTrees_r167,101529,456,6651,646765,653872
XT_168,ExtraTrees_r168,117239,456,6651,1511377,1518484
XT_169,ExtraTrees_r169,118120,458,6651,126224,133333
XT_170,ExtraTrees_r170,109601,456,6651,222262,229369
XT_171,ExtraTrees_r171,104345,456,6651,487305,494412
XT_172,ExtraTrees_r172,101593,458,6651,553470,560579
XT_173,ExtraTrees_r173,92871,456,6651,152597,159704
XT_174,ExtraTrees_r174,99665,458,6651,171353,178462
XT_175,ExtraTrees_r175,106153,458,6651,242451,249560
XT_176,ExtraTrees_r176,95163,458,6651,443117,450226
XT_177,ExtraTrees_r177,104249,458,6651,952141,959250
XT_178,ExtraTrees_r178,103041,458,6651,541585,548694
XT_179,ExtraTrees_r179,104839,458,6651,242451,249560
XT_180,ExtraTrees_r180,108313,456,6651,124108,131215
XT_181,ExtraTrees_r181,102677,456,6651,152597,159704
XT_182,ExtraTrees_r182,102953,456,6651,222262,229369
XT_183,ExtraTrees_r183,99857,458,6651,541585,548694
XT_184,ExtraTrees_r184,96405,458,6651,531077,538186
XT_185,ExtraTrees_r185,98301,458,6651,426909,434018
XT_186,ExtraTrees_r186,84987,456,6651,124108,131215
XT_187,ExtraTrees_r187,108114,458,6651,126224,133333
XT_188,ExtraTrees_r188,118605,458,6651,126224,133333
XT_189,ExtraTrees_r189,411743,456,6651,646765,653872
XT_190,ExtraTrees_r190,150825,456,6651,124108,131215
XT_191,ExtraTrees_r191,146457,458,6651,952141,959250
XT_192,ExtraTrees_r192,122565,456,6651,152597,159704
XT_193,ExtraTrees_r193,109047,456,6651,487305,494412
XT_194,ExtraTrees_r194,126593,458,6651,702025,709134
XT_195,ExtraTrees_r195,124777,458,6651,1207697,1214806
XT_196,ExtraTrees_r196,109305,458,6651,702025,709134
XT_197,ExtraTrees_r197,108281,458,6651,1122239,1129348
XT_198,ExtraTrees_r198,96411,458,6651,453224,460333
XT_199,ExtraTrees_r199,120225,456,6651,646765,653872
XT_200,ExtraTrees_r200,122053,458,6651,126224,133333
XGB_0,XGBoost_c1,115632,391,6663,8603,15657
XGB_1,XGBoost_c2,118457,417,6651,8607,15675
XGB_2,XGBoost_c3,92820,414,6663,8143,15220
XGB_3,XGBoost_c4,73222,439,6663,8171,15273
XGB_4,XGBoost_r1,103644,509,6651,8738,15898
XGB_5,XGBoost_r2,105124,509,6663,8762,15934
XGB_6,XGBoost_r3,104548,509,6663,8762,15934
XGB_7,XGBoost_r4,103812,509,6663,8762,15934
XGB_8,XGBoost_r5,109143,509,6663,8273,15445
XGB_9,XGBoost_r6,102748,509,6651,8738,15898
XGB_10,XGBoost_r7,97964,509,6663,8762,15934
XGB_11,XGBoost_r8,99844,509,6663,8762,15934
XGB_12,XGBoost_r9,109039,509,6663,8273,15445
XGB_13,XGBoost_r10,102630,510,6651,8742,15903
XGB_14,XGBoost_r11,97070,510,6663,8766,15939
XGB_15,XGBoost_r12,108457,510,6663,8277,15450
XGB_16,XGBoost_r13,101038,510,6663,8766,15939
XGB_17,XGBoost_r14,97758,510,6651,8742,15903
XGB_18,XGBoost_r15,93846,510,6663,8766,15939
XGB_19,XGBoost_r16,96022,510,6663,8766,15939
XGB_20,XGBoost_r17,93894,510,6663,8766,15939
XGB_21,XGBoost_r18,93894,510,6663,8766,15939
XGB_22,XGBoost_r19,93827,510,6651,8742,15903
XGB_23,XGBoost_r20,93846,510,6663,8766,15939
XGB_24,XGBoost_r21,94040,510,6663,8766,15939
XGB_25,XGBoost_r22,94757,510,6663,8766,15939
XGB_26,XGBoost_r23,96628,510,6651,8742,15903
XGB_27,XGBoost_r24,106777,510,6663,8277,15450
XGB_28,XGBoost_r25,114477,510,6663,8277,15450
XGB_29,XGBoost_r26,109793,510,6663,8277,15450
XGB_30,XGBoost_r27,110193,510,6651,8253,15414
XGB_31,XGBoost_r28,109105,510,6663,8277,15450
XGB_32,XGBoost_r29,101173,510,6663,8766,15939
XGB_33,XGBoost_r30,93750,510,6663,8767,15940
XGB_34,XGBoost_r31,96006,510,6651,8742,15903
XGB_35,XGBoost_r32,93854,510,6663,8766,15939
XGB_36,XGBoost_r33,93798,510,6663,8766,15939
XGB_37,XGBoost_r34,94000,510,6663,8766,15939
XGB_38,XGBoost_r35,93782,510,6651,8742,15903
XGB_39,XGBoost_r36,107097,510,6663,8277,15450
XGB_40,XGBoost_r37,113005,510,6663,8277,15450
XGB_41,XGBoost_r38,98662,510,6663,8766,15939
XGB_42,XGBoost_r39,97238,510,6651,8742,15903
XGB_43,XGBoost_r40,93858,510,6663,8766,15939
XGB_44,XGBoost_r41,93798,510,6663,8766,15939
XGB_45,XGBoost_r42,93750,510,6663,8766,15939
XGB_46,XGBoost_r43,96022,510,6663,8766,15939
XGB_47,XGBoost_r44,106025,510,6663,8277,15450
XGB_48,XGBoost_r45,99182,510,6651,8742,15903
XGB_49,XGBoost_r46,106137,510,6663,8277,15450
XGB_50,XGBoost_r47,98435,510,6663,8766,15939
XGB_51,XGBoost_r48,93798,510,6663,8766,15939
XGB_52,XGBoost_r49,104889,510,6663,8766,15939
XGB_53,XGBoost_r50,96816,510,6651,8742,15903
XGB_54,XGBoost_r51,108735,510,6663,8277,15450
XGB_55,XGBoost_r52,109105,510,6663,8277,15450
XGB_56,XGBoost_r53,109057,510,6663,8277,15450
XGB_57,XGBoost_r54,97558,510,6651,8742,15903
XGB_58,XGBoost_r55,105995,510,6663,8277,15450
XGB_59,XGBoost_r56,97825,510,6663,8766,15939
XGB_60,XGBoost_r57,107073,510,6663,8277,15450
XGB_61,XGBoost_r58,109157,510,6663,8277,15450
XGB_62,XGBoost_r59,110193,510,6651,8253,15414
XGB_63,XGBoost_r60,97622,510,6663,8766,15939
XGB_64,XGBoost_r61,97549,510,6663,8766,15939
XGB_65,XGBoost_r62,106985,510,6663,8277,15450
XGB_66,XGBoost_r63,100078,510,6651,8742,15903
XGB_67,XGBoost_r64,106844,510,6663,8277,15450
XGB_68,XGBoost_r65,98774,510,6663,8766,15939
XGB_69,XGBoost_r66,93798,510,6663,8766,15939
XGB_70,XGBoost_r67,96260,510,6663,8766,15939
XGB_71,XGBoost_r68,106655,510,6651,8253,15414
XGB_72,XGBoost_r69,99862,510,6663,8766,15939
XGB_73,XGBoost_r70,94030,510,6663,8766,15939
XGB_74,XGBoost_r71,105921,510,6663,8277,15450
XGB_75,XGBoost_r72,98526,510,6663,8766,15939
XGB_76,XGBoost_r73,107009,510,6651,8253,15414
XGB_77,XGBoost_r74,97622,510,6663,8766,15939
XGB_78,XGBoost_r75,96298,510,6663,8766,15939
XGB_79,XGBoost_r76,93750,510,6663,8766,15939
XGB_80,XGBoost_r77,96022,510,6663,8766,15939
XGB_81,XGBoost_r78,106121,510,6651,8253,15414
XGB_82,XGBoost_r79,99190,510,6663,8766,15939
XGB_83,XGBoost_r80,105865,510,6663,8277,15450
XGB_84,XGBoost_r81,98181,510,6663,8766,15939
XGB_85,XGBoost_r82,93798,510,6663,8766,15939
XGB_86,XGBoost_r83,107113,510,6651,8253,15414
XGB_87,XGBoost_r84,99198,510,6663,8766,15939
XGB_88,XGBoost_r85,94998,510,6663,8766,15939
XGB_89,XGBoost_r86,105873,510,6663,8277,15450
XGB_90,XGBoost_r87,111833,510,6663,8277,15450
XGB_91,XGBoost_r88,99510,510,6651,8742,15903
XGB_92,XGBoost_r89,95055,510,6663,8767,15940
XGB_93,XGBoost_r90,93750,510,6663,8766,15939
XGB_94,XGBoost_r91,108089,510,6663,8277,15450
XGB_95,XGBoost_r92,110913,510,6651,8253,15414
XGB_96,XGBoost_r93,110353,510,6663,8277,15450
XGB_97,XGBoost_r94,97574,510,6663,8766,15939
XGB_98,XGBoost_r95,93846,510,6663,8766,15939
XGB_99,XGBoost_r96,93750,510,6663,8766,15939
XGB_100,XGBoost_r97,107357,510,6651,8253,15414
XGB_101,XGBoost_r98,111198,510,6663,8277,15450
XGB_102,XGBoost_r99,111857,510,6663,8277,15450
XGB_103,XGBoost_r100,102316,511,6663,8770,15944
XGB_104,XGBoost_r101,111021,511,6651,8257,15419
XGB_105,XGBoost_r102,109107,511,6663,8281,15455
XGB_106,XGBoost_r103,99992,511,6663,8770,15944
XGB_107,XGBoost_r104,105819,511,6663,8281,15455
XGB_108,XGBoost_r105,98808,511,6651,8746,15908
XGB_109,XGBoost_r106,105875,511,6663,8281,15455
XGB_110,XGBoost_r107,81693,511,6663,8770,15944
XGB_111,XGBoost_r108,106096,511,6663,8770,15944
XGB_112,XGBoost_r109,82303,511,6663,8281,15455
XGB_113,XGBoost_r110,105664,511,6651,8746,15908
XGB_114,XGBoost_r111,78859,511,6663,8281,15455
XGB_115,XGBoost_r112,78482,511,6663,8281,15455
XGB_116,XGBoost_r113,78419,511,6663,8281,15455
XGB_117,XGBoost_r114,79515,511,6651,8257,15419
XGB_118,XGBoost_r115,79571,511,6663,8281,15455
XGB_119,XGBoost_r116,103280,511,6663,8770,15944
XGB_120,XGBoost_r117,104896,511,6663,8770,15944
XGB_121,XGBoost_r118,68719,511,6663,8281,15455
XGB_122,XGBoost_r119,113299,511,6651,8257,15419
XGB_123,XGBoost_r120,112459,511,6663,8281,15455
XGB_124,XGBoost_r121,113611,511,6663,8281,15455
XGB_125,XGBoost_r122,112459,511,6663,8281,15455
XGB_126,XGBoost_r123,113595,511,6651,8257,15419
XGB_127,XGBoost_r124,103504,511,6663,8770,15944
XGB_128,XGBoost_r125,104064,511,6663,8770,15944
XGB_129,XGBoost_r126,102912,511,6663,8770,15944
XGB_130,XGBoost_r127,114683,511,6663,8281,15455
XGB_131,XGBoost_r128,104008,511,6651,8746,15908
XGB_132,XGBoost_r129,112459,511,6663,8281,15455
XGB_133,XGBoost_r130,102144,511,6663,8770,15944
XGB_134,XGBoost_r131,107715,511,6663,8281,15455
XGB_135,XGBoost_r132,99568,511,6651,8746,15908
XGB_136,XGBoost_r133,107075,511,6663,8281,15455
XGB_137,XGBoost_r134,97658,511,6663,8770,15944
XGB_138,XGBoost_r135,103931,511,6663,8770,15944
XGB_139,XGBoost_r136,107811,511,6663,8281,15455
XGB_140,XGBoost_r137,98760,511,6651,8746,15908
XGB_141,XGBoost_r138,93800,511,6663,8770,15944
XGB_142,XGBoost_r139,108091,511,6663,8281,15455
XGB_143,XGBoost_r140,102157,511,6663,8770,15944
XGB_144,XGBoost_r141,95016,511,6663,8770,15944
XGB_145,XGBoost_r142,108797,511,6651,8257,15419
XGB_146,XGBoost_r143,111375,511,6663,8281,15455
XGB_147,XGBoost_r144,98160,511,6663,8770,15944
XGB_148,XGBoost_r145,110227,511,6663,8281,15455
XGB_149,XGBoost_r146,109107,511,6663,8281,15455
XGB_150,XGBoost_r147,98760,511,6651,8746,15908
XGB_151,XGBoost_r148,93848,511,6663,8770,15944
XGB_152,XGBoost_r149,96024,511,6663,8770,15944
XGB_153,XGBoost_r150,105987,511,6663,8281,15455
XGB_154,XGBoost_r151,99232,511,6651,8746,15908
XGB_155,XGBoost_r152,106171,511,6663,8281,15455
XGB_156,XGBoost_r153,97624,511,6663,8770,15944
XGB_157,XGBoost_r154,94864,511,6663,8770,15944
XGB_158,XGBoost_r155,94904,511,6663,8770,15944
XGB_159,XGBoost_r156,93859,511,6651,8746,15908
XGB_160,XGBoost_r157,108363,511,6663,8281,15455
XGB_161,XGBoost_r158,99040,511,6663,8770,15944
XGB_162,XGBoost_r159,106016,511,6663,8281,15455
XGB_163,XGBoost_r160,97608,511,6651,8746,15908
XGB_164,XGBoost_r161,93840,511,6663,8770,15944
XGB_165,XGBoost_r162,105875,511,6663,8281,15455
XGB_166,XGBoost_r163,100048,511,6663,8770,15944
XGB_167,XGBoost_r164,105955,511,6651,8257,15419
XGB_168,XGBoost_r165,98728,511,6663,8770,15944
XGB_169,XGBoost_r166,94486,511,6663,8770,15944
XGB_170,XGBoost_r167,97184,511,6663,8770,15944
XGB_171,XGBoost_r168,105939,511,6663,8281,15455
XGB_172,XGBoost_r169,110571,511,6651,8257,15419
XGB_173,XGBoost_r170,98560,511,6663,8770,15944
XGB_174,XGBoost_r171,105875,511,6663,8281,15455
XGB_175,XGBoost_r172,97672,511,6663,8770,15944
XGB_176,XGBoost_r173,94936,511,6651,8746,15908
XGB_177,XGBoost_r174,105867,511,6663,8281,15455
XGB_178,XGBoost_r175,100352,511,6663,8770,15944
XGB_179,XGBoost_r176,93848,511,6663,8770,15944
XGB_180,XGBoost_r177,95976,511,6663,8770,15944
XGB_181,XGBoost_r178,93688,511,6651,8746,15908
XGB_182,XGBoost_r179,93856,511,6663,8770,15944
XGB_183,XGBoost_r180,95008,511,6663,8770,15944
XGB_184,XGBoost_r181,106510,511,6663,8281,15455
XGB_185,XGBoost_r182,110931,511,6663,8281,15455
XGB_186,XGBoost_r183,111395,511,6651,8257,15419
XGB_187,XGBoost_r184,97624,511,6663,8770,15944
XGB_188,XGBoost_r185,94904,511,6663,8770,15944
XGB_189,XGBoost_r186,105827,511,6663,8281,15455
XGB_190,XGBoost_r187,100432,511,6651,8746,15908
XGB_191,XGBoost_r188,106083,511,6663,8281,15455
XGB_192,XGBoost_r189,98776,511,6663,8770,15944
XGB_193,XGBoost_r190,105923,511,6663,8281,15455
XGB_194,XGBoost_r191,98760,511,6651,8746,15908
XGB_195,XGBoost_r192,105875,511,6663,8281,15455
XGB_196,XGBoost_r193,114971,511,6663,8281,15455
XGB_197,XGBoost_r194,109059,511,6663,8281,15455
XGB_198,XGBoost_r195,98776,511,6663,8770,15944
XGB_199,XGBoost_r196,105907,511,6651,8257,15419
XGB_200,XGBoost_r197,98888,511,6663,8770,15944
XGB_201,XGBoost_r198,105875,511,6663,8281,15455
XGB_202,XGBoost_r199,110211,511,6663,8281,15455
XGB_203,XGBoost_r200,97560,511,6651,8746,15908
TABPFN_0,TabPFN_c1,262874,394,6651,103371201,103378246
TABPFN_1,TabPFN_c2,112187,425,6663,103371262,103378350
TABPFN_2,TabPFN_c3,87271,425,6663,103371262,103378350
RF_0,RandomForest_c1,142429,390,6663,889146,896199
RF_1,RandomForest_r1,115927,456,6651,270028,277135
RF_2,RandomForest_r2,116901,454,6651,540408,547513
RF_3,RandomForest_r3,113761,454,6651,639894,646999
RF_4,RandomForest_r4,116417,456,6651,174393,181500
RF_5,RandomForest_r5,126097,454,6651,763115,770220
RF_6,RandomForest_r6,109667,454,6651,267583,274688
RF_7,RandomForest_r7,106229,454,6651,124105,131210
RF_8,RandomForest_r8,109521,454,6651,540408,547513
RF_9,RandomForest_r9,115587,454,6651,267583,274688
RF_10,RandomForest_r10,529275,455,6651,124109,131215
RF_11,RandomForest_r11,157087,455,6651,540412,547518
RF_12,RandomForest_r12,124179,457,6651,126225,133333
RF_13,RandomForest_r13,113857,455,6651,889217,896323
RF_14,RandomForest_r14,120027,457,6651,126225,133333
RF_15,RandomForest_r15,122531,457,6651,591104,598212
RF_16,RandomForest_r16,117295,457,6651,730343,737451
RF_17,RandomForest_r17,117155,457,6651,270032,277140
RF_18,RandomForest_r18,129919,455,6651,763119,770225
RF_19,RandomForest_r19,102505,457,6651,661374,668482
RF_20,RandomForest_r20,107563,455,6651,540412,547518
RF_21,RandomForest_r21,119299,457,6651,591104,598212
RF_22,RandomForest_r22,124429,457,6651,449874,456982
RF_23,RandomForest_r23,112683,457,6651,174397,181505
RF_24,RandomForest_r24,105291,457,6651,441168,448276
RF_25,RandomForest_r25,105543,457,6651,449874,456982
RF_26,RandomForest_r26,101095,455,6651,461741,468847
RF_27,RandomForest_r27,94785,457,6651,126225,133333
RF_28,RandomForest_r28,113671,455,6651,540412,547518
RF_29,RandomForest_r29,104391,455,6651,267587,274693
RF_30,RandomForest_r30,128129,455,6651,461741,468847
RF_31,RandomForest_r31,120151,457,6651,529363,536471
RF_32,RandomForest_r32,112159,457,6651,807324,814432
RF_33,RandomForest_r33,114547,455,6651,639898,647004
RF_34,RandomForest_r34,101191,457,6651,126225,133333
RF_35,RandomForest_r35,97329,457,6651,591104,598212
RF_36,RandomForest_r36,121443,457,6651,513276,520384
RF_37,RandomForest_r37,117607,457,6651,529363,536471
RF_38,RandomForest_r38,118681,457,6651,573163,580271
RF_39,RandomForest_r39,108683,457,6651,681546,688654
RF_40,RandomForest_r40,108447,457,6651,174397,181505
RF_41,RandomForest_r41,101387,457,6651,591104,598212
RF_42,RandomForest_r42,96967,457,6651,763475,770583
RF_43,RandomForest_r43,92129,455,6651,540412,547518
RF_44,RandomForest_r44,98499,457,6651,126225,133333
RF_45,RandomForest_r45,108127,455,6651,639898,647004
RF_46,RandomForest_r46,93961,457,6651,591104,598212
RF_47,RandomForest_r47,95859,457,6651,126225,133333
RF_48,RandomForest_r48,110155,457,6651,591104,598212
RF_49,RandomForest_r49,102539,455,6651,889217,896323
RF_50,RandomForest_r50,118331,457,6651,174397,181505
RF_51,RandomForest_r51,447672,455,6651,124109,131215
RF_52,RandomForest_r52,116336,455,6651,267587,274693
RF_53,RandomForest_r53,129667,455,6651,172281,179387
RF_54,RandomForest_r54,116467,457,6651,126225,133333
RF_55,RandomForest_r55,104483,455,6651,172281,179387
RF_56,RandomForest_r56,108267,455,6651,639898,647004
RF_57,RandomForest_r57,100057,455,6651,172281,179387
RF_58,RandomForest_r58,126455,455,6651,124109,131215
RF_59,RandomForest_r59,106295,455,6651,639898,647004
RF_60,RandomForest_r60,117689,457,6651,174397,181505
RF_61,RandomForest_r61,130899,457,6651,269872,276980
RF_62,RandomForest_r62,117771,457,6651,126225,133333
RF_63,RandomForest_r63,111847,457,6651,174397,181505
RF_64,RandomForest_r64,101679,457,6651,126225,133333
RF_65,RandomForest_r65,100407,457,6651,126225,133333
RF_66,RandomForest_r66,104831,457,6651,449874,456982
RF_67,RandomForest_r67,98999,457,6651,126225,133333
RF_68,RandomForest_r68,99567,455,6651,124109,131215
RF_69,RandomForest_r69,113051,457,6651,591104,598212
RF_70,RandomForest_r70,104375,457,6651,126225,133333
RF_71,RandomForest_r71,103587,455,6651,639898,647004
RF_72,RandomForest_r72,99531,455,6651,267587,274693
RF_73,RandomForest_r73,89933,455,6651,461741,468847
RF_74,RandomForest_r74,100539,455,6651,267587,274693
RF_75,RandomForest_r75,97587,455,6651,124109,131215
RF_76,RandomForest_r76,99355,455,6651,540412,547518
RF_77,RandomForest_r77,95519,455,6651,124109,131215
RF_78,RandomForest_r78,104593,457,6651,730343,737451
RF_79,RandomForest_r79,103791,455,6651,124109,131215
RF_80,RandomForest_r80,110203,457,6651,573163,580271
RF_81,RandomForest_r81,121457,455,6651,763119,770225
RF_82,RandomForest_r82,116371,457,6651,573163,580271
RF_83,RandomForest_r83,116739,457,6651,270032,277140
RF_84,RandomForest_r84,105051,457,6651,270032,277140
RF_85,RandomForest_r85,106263,457,6651,681546,688654
RF_86,RandomForest_r86,121423,457,6651,529363,536471
RF_87,RandomForest_r87,111227,455,6651,267587,274693
RF_88,RandomForest_r88,109833,455,6651,639898,647004
RF_89,RandomForest_r89,96113,455,6651,763119,770225
RF_90,RandomForest_r90,100475,455,6651,172281,179387
RF_91,RandomForest_r91,94059,455,6651,461741,468847
RF_92,RandomForest_r92,96467,455,6651,540412,547518
RF_93,RandomForest_r93,98019,457,6651,126225,133333
RF_94,RandomForest_r94,91249,455,6651,124109,131215
RF_95,RandomForest_r95,121011,457,6651,454034,461142
RF_96,RandomForest_r96,540547,455,6651,461741,468847
RF_97,RandomForest_r97,147276,455,6651,172281,179387
RF_98,RandomForest_r98,125468,457,6651,573163,580271
RF_99,RandomForest_r99,153090,457,6651,501183,508291
RF_100,RandomForest_r100,120957,456,6651,267591,274698
RF_101,RandomForest_r101,108453,456,6651,267591,274698
RF_102,RandomForest_r102,108523,458,6651,126229,133338
RF_103,RandomForest_r103,123793,458,6651,441172,448281
RF_104,RandomForest_r104,119669,456,6651,540416,547523
RF_105,RandomForest_r105,109585,458,6651,591108,598217
RF_106,RandomForest_r106,102981,458,6651,126229,133338
RF_107,RandomForest_r107,93551,458,6651,126229,133338
RF_108,RandomForest_r108,102549,456,6651,267591,274698
RF_109,RandomForest_r109,99065,456,6651,889221,896328
RF_110,RandomForest_r110,126005,458,6651,529367,536476
RF_111,RandomForest_r111,110269,458,6651,174401,181510
RF_112,RandomForest_r112,118645,456,6651,889221,896328
RF_113,RandomForest_r113,103733,456,6651,124113,131220
RF_114,RandomForest_r114,119205,458,6651,681550,688659
RF_115,RandomForest_r115,107813,458,6651,573167,580276
RF_116,RandomForest_r116,121551,458,6651,126229,133338
RF_117,RandomForest_r117,120549,456,6651,461745,468852
RF_118,RandomForest_r118,105261,458,6651,126229,133338
RF_119,RandomForest_r119,97275,456,6651,763123,770230
RF_120,RandomForest_r120,105217,456,6651,763123,770230
RF_121,RandomForest_r121,115313,458,6651,126229,133338
RF_122,RandomForest_r122,108525,458,6651,174401,181510
RF_123,RandomForest_r123,103817,456,6651,172285,179392
RF_124,RandomForest_r124,95531,456,6651,124113,131220
RF_125,RandomForest_r125,107173,458,6651,441172,448281
RF_126,RandomForest_r126,100733,456,6651,763123,770230
RF_127,RandomForest_r127,97493,458,6651,441172,448281
RF_128,RandomForest_r128,98449,456,6651,124113,131220
RF_129,RandomForest_r129,99369,458,6651,449878,456987
RF_130,RandomForest_r130,97101,456,6651,540416,547523
RF_131,RandomForest_r131,104113,458,6651,591108,598217
RF_132,RandomForest_r132,91071,456,6651,639902,647009
RF_133,RandomForest_r133,98905,456,6651,461745,468852
RF_134,RandomForest_r134,101189,458,6651,807328,814437
RF_135,RandomForest_r135,93843,456,6651,461745,468852
RF_136,RandomForest_r136,96589,458,6651,126229,133338
RF_137,RandomForest_r137,104965,458,6651,441172,448281
RF_138,RandomForest_r138,84554,458,6651,126229,133338
RF_139,RandomForest_r139,191629,458,6651,269876,276985
RF_140,RandomForest_r140,134829,456,6651,124113,131220
RF_141,RandomForest_r141,128793,458,6651,501187,508296
RF_142,RandomForest_r142,112471,458,6651,501187,508296
RF_143,RandomForest_r143,112521,456,6651,540416,547523
RF_144,RandomForest_r144,110685,458,6651,730347,737456
RF_145,RandomForest_r145,113761,456,6651,172285,179392
RF_146,RandomForest_r146,108577,456,6651,540416,547523
RF_147,RandomForest_r147,104225,458,6651,126229,133338
RF_148,RandomForest_r148,103053,456,6651,889221,896328
RF_149,RandomForest_r149,116385,458,6651,681550,688659
RF_150,RandomForest_r150,110299,458,6651,573167,580276
RF_151,RandomForest_r151,113989,456,6651,763123,770230
RF_152,RandomForest_r152,109497,458,6651,449878,456987
RF_153,RandomForest_r153,115163,456,6651,461745,468852
RF_154,RandomForest_r154,118797,456,6651,461745,468852
RF_155,RandomForest_r155,106292,456,6651,124113,131220
RF_156,RandomForest_r156,107293,458,6651,126229,133338
RF_157,RandomForest_r157,102153,458,6651,609215,616324
RF_158,RandomForest_r158,99237,458,6651,807328,814437
RF_159,RandomForest_r159,97813,458,6651,126229,133338
RF_160,RandomForest_r160,116729,456,6651,267591,274698
RF_161,RandomForest_r161,95523,458,6651,126229,133338
RF_162,RandomForest_r162,120665,458,6651,573167,580276
RF_163,RandomForest_r163,112949,458,6651,270036,277145
RF_164,RandomForest_r164,107909,458,6651,449878,456987
RF_165,RandomForest_r165,114323,458,6651,609215,616324
RF_166,RandomForest_r166,126545,456,6651,889221,896328
RF_167,RandomForest_r167,117425,456,6651,639902,647009
RF_168,RandomForest_r168,116077,456,6651,889221,896328
RF_169,RandomForest_r169,101877,458,6651,126229,133338
RF_170,RandomForest_r170,102739,456,6651,267591,274698
RF_171,RandomForest_r171,101917,456,6651,540416,547523
RF_172,RandomForest_r172,109421,458,6651,501187,508296
RF_173,RandomForest_r173,103741,456,6651,172285,179392
RF_174,RandomForest_r174,102413,458,6651,174401,181510
RF_175,RandomForest_r175,89971,458,6651,270036,277145
RF_176,RandomForest_r176,98405,458,6651,449878,456987
RF_177,RandomForest_r177,107849,458,6651,681550,688659
RF_178,RandomForest_r178,108295,458,6651,513280,520389
RF_179,RandomForest_r179,107825,458,6651,270036,277145
RF_180,RandomForest_r180,482474,456,6651,124113,131220
RF_181,RandomForest_r181,128005,456,6651,172285,179392
RF_182,RandomForest_r182,102013,456,6651,267591,274698
RF_183,RandomForest_r183,105641,458,6651,513280,520389
RF_184,RandomForest_r184,104925,458,6651,529367,536476
RF_185,RandomForest_r185,110061,458,6651,454038,461147
RF_186,RandomForest_r186,102105,456,6651,124113,131220
RF_187,RandomForest_r187,98189,458,6651,126229,133338
RF_188,RandomForest_r188,129533,458,6651,126229,133338
RF_189,RandomForest_r189,113417,456,6651,639902,647009
RF_190,RandomForest_r190,102305,456,6651,124113,131220
RF_191,RandomForest_r191,117717,458,6651,681550,688659
RF_192,RandomForest_r192,102861,456,6651,172285,179392
RF_193,RandomForest_r193,109649,456,6651,540416,547523
RF_194,RandomForest_r194,102025,458,6651,573167,580276
RF_195,RandomForest_r195,106917,458,6651,763479,770588
RF_196,RandomForest_r196,123389,458,6651,573167,580276
RF_197,RandomForest_r197,96387,458,6651,730347,737456
RF_198,RandomForest_r198,103641,458,6651,441172,448281
RF_199,RandomForest_r199,114709,456,6651,639902,647009
RF_200,RandomForest_r200,106201,458,6651,126229,133338
NN_TORCH_0,NeuralNetTorch_c1,93559,396,6663,221941,229000
NN_TORCH_1,NeuralNetTorch_c2,104792,414,6651,234934,241999
NN_TORCH_2,NeuralNetTorch_c3,91082,412,6663,88081,95156
NN_TORCH_3,NeuralNetTorch_c4,89055,429,6663,93720,100812
NN_TORCH_4,NeuralNetTorch_r1,88206,538,6651,526544,533733
NN_TORCH_5,NeuralNetTorch_r2,90381,537,6663,19543,26743
NN_TORCH_6,NeuralNetTorch_r3,97798,538,6663,164700,171901
NN_TORCH_7,NeuralNetTorch_r4,85745,538,6651,27618,34807
NN_TORCH_8,NeuralNetTorch_r5,83322,537,6663,24610,31810
NN_TORCH_9,NeuralNetTorch_r6,82588,537,6663,559973,567173
NN_TORCH_10,NeuralNetTorch_r7,82384,537,6651,21652,28840
NN_TORCH_11,NeuralNetTorch_r8,84821,538,6663,183612,190813
NN_TORCH_12,NeuralNetTorch_r9,84249,537,6651,162338,169526
NN_TORCH_13,NeuralNetTorch_r10,84431,538,6663,225285,232486
NN_TORCH_14,NeuralNetTorch_r11,84877,538,6651,336796,343985
NN_TORCH_15,NeuralNetTorch_r12,83842,539,6651,18127,25317
NN_TORCH_16,NeuralNetTorch_r13,83525,538,6663,195131,202332
NN_TORCH_17,NeuralNetTorch_r14,81546,539,6651,22027,29217
NN_TORCH_18,NeuralNetTorch_r15,82155,538,6663,203743,210944
NN_TORCH_19,NeuralNetTorch_r16,82763,539,6651,231615,238805
NN_TORCH_20,NeuralNetTorch_r17,82345,538,6651,55208,62397
NN_TORCH_21,NeuralNetTorch_r18,82273,538,6663,19183,26384
NN_TORCH_22,NeuralNetTorch_r19,81474,539,6663,26732,33934
NN_TORCH_23,NeuralNetTorch_r20,82082,539,6651,17606,24796
NN_TORCH_24,NeuralNetTorch_r21,81254,539,6663,24370,31572
NN_TORCH_25,NeuralNetTorch_r22,81942,538,6663,575397,582598
NN_TORCH_26,NeuralNetTorch_r23,81565,538,6651,21721,28910
NN_TORCH_27,NeuralNetTorch_r24,82667,538,6663,381690,388891
NN_TORCH_28,NeuralNetTorch_r25,83101,538,6651,173735,180924
NN_TORCH_29,NeuralNetTorch_r26,81648,538,6651,84305,91494
NN_TORCH_30,NeuralNetTorch_r27,81801,539,6663,89604,96806
NN_TORCH_31,NeuralNetTorch_r28,82219,538,6651,495629,502818
NN_TORCH_32,NeuralNetTorch_r29,85825,539,6651,1003543,1010733
NN_TORCH_33,NeuralNetTorch_r30,85878,538,6651,452181,459370
NN_TORCH_34,NeuralNetTorch_r31,81772,538,6663,101234,108435
NN_TORCH_35,NeuralNetTorch_r32,81811,539,6651,17610,24800
NN_TORCH_36,NeuralNetTorch_r33,81362,539,6663,29020,36222
NN_TORCH_37,NeuralNetTorch_r34,82064,539,6663,56406,63608
NN_TORCH_38,NeuralNetTorch_r35,81480,539,6651,89511,96701
NN_TORCH_39,NeuralNetTorch_r36,81848,538,6663,35988,43189
NN_TORCH_40,NeuralNetTorch_r37,82052,538,6663,126717,133918
NN_TORCH_41,NeuralNetTorch_r38,82897,538,6651,225611,232800
NN_TORCH_42,NeuralNetTorch_r39,81333,538,6663,158239,165440
NN_TORCH_43,NeuralNetTorch_r40,81249,538,6651,25868,33057
NN_TORCH_44,NeuralNetTorch_r41,82154,539,6663,40016,47218
NN_TORCH_45,NeuralNetTorch_r42,82172,538,6651,759249,766438
NN_TORCH_46,NeuralNetTorch_r43,81410,538,6663,23210,30411
NN_TORCH_47,NeuralNetTorch_r44,81958,538,6663,27434,34635
NN_TORCH_48,NeuralNetTorch_r45,81081,538,6651,22020,29209
NN_TORCH_49,NeuralNetTorch_r46,81729,538,6663,271943,279144
NN_TORCH_50,NeuralNetTorch_r47,82003,538,6651,485047,492236
NN_TORCH_51,NeuralNetTorch_r48,82101,539,6663,19687,26889
NN_TORCH_52,NeuralNetTorch_r49,81515,539,6663,115864,123066
NN_TORCH_53,NeuralNetTorch_r50,81490,538,6651,23238,30427
NN_TORCH_54,NeuralNetTorch_r51,81858,540,6663,29862,37065
NN_TORCH_55,NeuralNetTorch_r52,83022,538,6651,25088,32277
NN_TORCH_56,NeuralNetTorch_r53,81437,539,6663,267345,274547
NN_TORCH_57,NeuralNetTorch_r54,83115,538,6663,36105,43306
NN_TORCH_58,NeuralNetTorch_r55,81465,538,6651,24464,31653
NN_TORCH_59,NeuralNetTorch_r56,81622,538,6663,314640,321841
NN_TORCH_60,NeuralNetTorch_r57,81975,539,6663,771912,779114
NN_TORCH_61,NeuralNetTorch_r58,82007,539,6651,507092,514282
NN_TORCH_62,NeuralNetTorch_r59,82233,538,6663,902700,909901
NN_TORCH_63,NeuralNetTorch_r60,81967,538,6651,40006,47195
NN_TORCH_64,NeuralNetTorch_r61,81079,539,6651,646178,653368
NN_TORCH_65,NeuralNetTorch_r62,81417,538,6651,24412,31601
NN_TORCH_66,NeuralNetTorch_r63,83782,538,6663,257319,264520
NN_TORCH_67,NeuralNetTorch_r64,83230,539,6651,195718,202908
NN_TORCH_68,NeuralNetTorch_r65,82891,539,6663,55743,62945
NN_TORCH_69,NeuralNetTorch_r66,83078,538,6651,94309,101498
NN_TORCH_70,NeuralNetTorch_r67,85182,539,6663,37235,44437
NN_TORCH_71,NeuralNetTorch_r68,82536,538,6663,196878,204079
NN_TORCH_72,NeuralNetTorch_r69,81692,538,6651,540543,547732
NN_TORCH_73,NeuralNetTorch_r70,81897,538,6663,25424,32625
NN_TORCH_74,NeuralNetTorch_r71,81417,539,6651,24762,31952
NN_TORCH_75,NeuralNetTorch_r72,81533,538,6663,17107,24308
NN_TORCH_76,NeuralNetTorch_r73,81521,539,6663,63422,70624
NN_TORCH_77,NeuralNetTorch_r74,82463,538,6651,475788,482977
NN_TORCH_78,NeuralNetTorch_r75,81642,538,6651,29062,36251
NN_TORCH_79,NeuralNetTorch_r76,81850,539,6663,26524,33726
NN_TORCH_80,NeuralNetTorch_r77,81793,538,6663,759273,766474
NN_TORCH_81,NeuralNetTorch_r78,84674,539,6651,350474,357664
NN_TORCH_82,NeuralNetTorch_r79,83143,538,6663,176231,183432
NN_TORCH_83,NeuralNetTorch_r80,81562,538,6651,24018,31207
NN_TORCH_84,NeuralNetTorch_r81,81689,538,6663,183951,191152
NN_TORCH_85,NeuralNetTorch_r82,84072,539,6651,544735,551925
NN_TORCH_86,NeuralNetTorch_r83,81372,539,6663,105823,113025
NN_TORCH_87,NeuralNetTorch_r84,81985,538,6651,19887,27076
NN_TORCH_88,NeuralNetTorch_r85,81728,538,6663,125070,132271
NN_TORCH_89,NeuralNetTorch_r86,81726,539,6663,318998,326200
NN_TORCH_90,NeuralNetTorch_r87,81788,539,6651,102543,109733
NN_TORCH_91,NeuralNetTorch_r88,81756,539,6663,297354,304556
NN_TORCH_92,NeuralNetTorch_r89,82207,539,6663,524377,531579
NN_TORCH_93,NeuralNetTorch_r90,82616,539,6651,42577,49767
NN_TORCH_94,NeuralNetTorch_r91,81798,539,6651,1035194,1042384
NN_TORCH_95,NeuralNetTorch_r92,82882,538,6663,257319,264520
NN_TORCH_96,NeuralNetTorch_r93,105849,539,6651,15608,22798
NN_TORCH_97,NeuralNetTorch_r94,90926,538,6663,172197,179398
NN_TORCH_98,NeuralNetTorch_r95,90772,539,6651,170953,178143
NN_TORCH_99,NeuralNetTorch_r96,90914,538,6663,296330,303531
NN_TORCH_100,NeuralNetTorch_r97,88928,538,6651,783313,790502
NN_TORCH_101,NeuralNetTorch_r98,89879,538,6663,253050,260251
NN_TORCH_102,NeuralNetTorch_r99,87451,539,6651,20515,27705
NN_TORCH_103,NeuralNetTorch_r100,88394,540,6663,20216,27419
NN_TORCH_104,NeuralNetTorch_r101,88284,540,6651,699635,706826
NN_TORCH_105,NeuralNetTorch_r102,87110,540,6651,36477,43668
NN_TORCH_106,NeuralNetTorch_r103,86481,540,6651,357224,364415
NN_TORCH_107,NeuralNetTorch_r104,86828,540,6663,20183,27386
NN_TORCH_108,NeuralNetTorch_r105,86548,540,6663,63458,70661
NN_TORCH_109,NeuralNetTorch_r106,88160,540,6651,378726,385917
NN_TORCH_110,NeuralNetTorch_r107,87755,539,6651,21816,29006
NN_TORCH_111,NeuralNetTorch_r108,86892,540,6663,19871,27074
NN_TORCH_112,NeuralNetTorch_r109,87993,539,6663,50693,57895
NN_TORCH_113,NeuralNetTorch_r110,86675,539,6663,100785,107987
NN_TORCH_114,NeuralNetTorch_r111,86363,539,6651,142814,150004
NN_TORCH_115,NeuralNetTorch_r112,86740,539,6663,107365,114567
NN_TORCH_116,NeuralNetTorch_r113,87352,539,6663,198345,205547
NN_TORCH_117,NeuralNetTorch_r114,88429,539,6651,712277,719467
NN_TORCH_118,NeuralNetTorch_r115,84382,540,6663,436337,443540
NN_TORCH_119,NeuralNetTorch_r116,84495,540,6663,27435,34638
NN_TORCH_120,NeuralNetTorch_r117,82076,540,6651,223976,231167
NN_TORCH_121,NeuralNetTorch_r118,81706,540,6663,84319,91522
NN_TORCH_122,NeuralNetTorch_r119,82916,539,6663,19105,26307
NN_TORCH_123,NeuralNetTorch_r120,81865,540,6651,38284,45475
NN_TORCH_124,NeuralNetTorch_r121,81992,540,6651,1011138,1018329
NN_TORCH_125,NeuralNetTorch_r122,81860,540,6663,34233,41436
NN_TORCH_126,NeuralNetTorch_r123,82110,540,6651,30850,38041
NN_TORCH_127,NeuralNetTorch_r124,83078,539,6663,312475,319677
NN_TORCH_128,NeuralNetTorch_r125,81518,539,6663,93201,100403
NN_TORCH_129,NeuralNetTorch_r126,81792,540,6651,215687,222878
NN_TORCH_130,NeuralNetTorch_r127,81857,539,6663,777934,785136
NN_TORCH_131,NeuralNetTorch_r128,81773,539,6651,136414,143604
NN_TORCH_132,NeuralNetTorch_r129,82058,539,6663,96082,103284
NN_TORCH_133,NeuralNetTorch_r130,81100,539,6663,91697,98899
NN_TORCH_134,NeuralNetTorch_r131,81276,539,6651,27610,34800
NN_TORCH_135,NeuralNetTorch_r132,81517,540,6663,622943,630146
NN_TORCH_136,NeuralNetTorch_r133,82969,540,6663,285580,292783
NN_TORCH_137,NeuralNetTorch_r134,82478,540,6651,356733,363924
NN_TORCH_138,NeuralNetTorch_r135,81388,539,6651,377485,384675
NN_TORCH_139,NeuralNetTorch_r136,81840,539,6663,233905,241107
NN_TORCH_140,NeuralNetTorch_r137,81549,539,6651,22836,30026
NN_TORCH_141,NeuralNetTorch_r138,81631,539,6663,16371,23573
NN_TORCH_142,NeuralNetTorch_r139,81964,540,6663,171200,178403
NN_TORCH_143,NeuralNetTorch_r140,81857,539,6651,53741,60931
NN_TORCH_144,NeuralNetTorch_r141,81397,540,6651,95284,102475
NN_TORCH_145,NeuralNetTorch_r142,82478,540,6663,815871,823074
NN_TORCH_146,NeuralNetTorch_r143,81684,539,6651,773789,780979
NN_TORCH_147,NeuralNetTorch_r144,81793,539,6651,62410,69600
NN_TORCH_148,NeuralNetTorch_r145,81874,539,6663,107602,114804
NN_TORCH_149,NeuralNetTorch_r146,83343,540,6663,275445,282648
NN_TORCH_150,NeuralNetTorch_r147,81811,540,6651,19097,26288
NN_TORCH_151,NeuralNetTorch_r148,81761,540,6663,424320,431523
NN_TORCH_152,NeuralNetTorch_r149,82034,539,6663,101742,108944
NN_TORCH_153,NeuralNetTorch_r150,84310,539,6651,170971,178161
NN_TORCH_154,NeuralNetTorch_r151,81751,539,6663,226959,234161
NN_TORCH_155,NeuralNetTorch_r152,81706,540,6663,282980,290183
NN_TORCH_156,NeuralNetTorch_r153,82363,539,6651,402631,409821
NN_TORCH_157,NeuralNetTorch_r154,81857,539,6663,820634,827836
NN_TORCH_158,NeuralNetTorch_r155,81235,540,6651,52998,60189
NN_TORCH_159,NeuralNetTorch_r156,81892,539,6651,416429,423619
NN_TORCH_160,NeuralNetTorch_r157,81732,540,6651,895971,903162
NN_TORCH_161,NeuralNetTorch_r158,82036,539,6663,238494,245696
NN_TORCH_162,NeuralNetTorch_r159,81717,540,6651,43323,50514
NN_TORCH_163,NeuralNetTorch_r160,83016,539,6663,902704,909906
NN_TORCH_164,NeuralNetTorch_r161,81565,540,6663,43347,50550
NN_TORCH_165,NeuralNetTorch_r162,81625,540,6651,87237,94428
NN_TORCH_166,NeuralNetTorch_r163,82180,539,6663,23109,30311
NN_TORCH_167,NeuralNetTorch_r164,82051,540,6651,23154,30345
NN_TORCH_168,NeuralNetTorch_r165,81451,540,6663,21201,28404
NN_TORCH_169,NeuralNetTorch_r166,82871,540,6663,26999,34202
NN_TORCH_170,NeuralNetTorch_r167,82203,539,6651,23532,30722
NN_TORCH_171,NeuralNetTorch_r168,81423,540,6663,208945,216148
NN_TORCH_172,NeuralNetTorch_r169,81984,540,6663,30769,37972
NN_TORCH_173,NeuralNetTorch_r170,81892,539,6651,305741,312931
NN_TORCH_174,NeuralNetTorch_r171,81539,540,6663,85131,92334
NN_TORCH_175,NeuralNetTorch_r172,81517,540,6663,261487,268690
NN_TORCH_176,NeuralNetTorch_r173,82700,540,6651,24112,31303
NN_TORCH_177,NeuralNetTorch_r174,82680,539,6663,481244,488446
NN_TORCH_178,NeuralNetTorch_r175,81715,540,6651,15820,23011
NN_TORCH_179,NeuralNetTorch_r176,81806,540,6663,217941,225144
NN_TORCH_180,NeuralNetTorch_r177,82766,539,6663,54132,61334
NN_TORCH_181,NeuralNetTorch_r178,81435,540,6651,18369,25560
NN_TORCH_182,NeuralNetTorch_r179,81706,540,6663,72607,79810
NN_TORCH_183,NeuralNetTorch_r180,81678,539,6651,124869,132059
NN_TORCH_184,NeuralNetTorch_r181,82174,539,6663,124893,132095
NN_TORCH_185,NeuralNetTorch_r182,81651,540,6663,18341,25544
NN_TORCH_186,NeuralNetTorch_r183,81549,539,6651,544753,551943
NN_TORCH_187,NeuralNetTorch_r184,81535,539,6663,217859,225061
NN_TORCH_188,NeuralNetTorch_r185,82418,540,6651,314676,321867
NN_TORCH_189,NeuralNetTorch_r186,81405,540,6663,633775,640978
NN_TORCH_190,NeuralNetTorch_r187,82895,539,6663,243843,251045
NN_TORCH_191,NeuralNetTorch_r188,81303,540,6651,289897,297088
NN_TORCH_192,NeuralNetTorch_r189,81616,540,6663,602610,609813
NN_TORCH_193,NeuralNetTorch_r190,84710,540,6651,544617,551808
NN_TORCH_194,NeuralNetTorch_r191,81678,539,6663,26126,33328
NN_TORCH_195,NeuralNetTorch_r192,81494,539,6663,508475,515677
NN_TORCH_196,NeuralNetTorch_r193,82083,539,6651,161571,168761
NN_TORCH_197,NeuralNetTorch_r194,81812,540,6663,165176,172379
NN_TORCH_198,NeuralNetTorch_r195,82509,540,6651,23310,30501
NN_TORCH_199,NeuralNetTorch_r196,81323,539,6663,20643,27845
NN_TORCH_200,NeuralNetTorch_r197,81051,539,6663,27612,34814
NN_TORCH_201,NeuralNetTorch_r198,81815,540,6651,292030,299221
NN_TORCH_202,NeuralNetTorch_r199,81565,539,6663,311789,318991
NN_TORCH_203,NeuralNetTorch_r200,82996,539,6663,125074,132276
LR_0,LinearModel_c1,101856,390,6663,10502,17555
LR_1,LinearModel_c2,95536,414,6651,10497,17562
LR_2,LinearModel_r1,94200,474,6663,10591,17728
LR_3,LinearModel_r2,98504,472,6651,10565,17688
LR_4,LinearModel_r3,88072,480,6663,10605,17748
LR_5,LinearModel_r4,86296,482,6651,10583,17716
LR_6,LinearModel_r5,87032,482,6663,10607,17752
LR_7,LinearModel_r6,86440,480,6651,10581,17712
LR_8,LinearModel_r7,86600,474,6663,10591,17728
LR_9,LinearModel_r8,87992,480,6663,10605,17748
LR_10,LinearModel_r9,85516,472,6651,10565,17688
LR_11,LinearModel_r10,86268,475,6663,10595,17733
LR_12,LinearModel_r11,86562,473,6663,10593,17729
LR_13,LinearModel_r12,85482,475,6663,10595,17733
LR_14,LinearModel_r13,84962,475,6663,10595,17733
LR_15,LinearModel_r14,84706,483,6663,10611,17757
LR_16,LinearModel_r15,84754,483,6663,10611,17757
LR_17,LinearModel_r16,85426,481,6663,10609,17753
LR_18,LinearModel_r17,84610,481,6663,10609,17753
LR_19,LinearModel_r18,89250,481,6663,10609,17753
LR_20,LinearModel_r19,84786,475,6663,10595,17733
LR_21,LinearModel_r20,85538,481,6651,10585,17717
LR_22,LinearModel_r21,84746,481,6663,10609,17753
LR_23,LinearModel_r22,84834,481,6663,10609,17753
LR_24,LinearModel_r23,84962,483,6663,10611,17757
LR_25,LinearModel_r24,86986,481,6663,10609,17753
LR_26,LinearModel_r25,84794,481,6663,10609,17753
LR_27,LinearModel_r26,84658,473,6663,10593,17729
LR_28,LinearModel_r27,84754,483,6663,10611,17757
LR_29,LinearModel_r28,86098,483,6663,10611,17757
LR_30,LinearModel_r29,84842,483,6663,10611,17757
LR_31,LinearModel_r30,84698,473,6663,10593,17729
LR_32,LinearModel_r31,87930,481,6651,10585,17717
LR_33,LinearModel_r32,86170,483,6663,10611,17757
LR_34,LinearModel_r33,84898,475,6663,10595,17733
LR_35,LinearModel_r34,84706,481,6663,10609,17753
LR_36,LinearModel_r35,84842,483,6663,10611,17757
LR_37,LinearModel_r36,86170,483,6663,10611,17757
LR_38,LinearModel_r37,86010,475,6663,10595,17733
LR_39,LinearModel_r38,84850,483,6663,10611,17757
LR_40,LinearModel_r39,84866,481,6663,10609,17753
LR_41,LinearModel_r40,95674,483,6663,10611,17757
LR_42,LinearModel_r41,84890,483,6663,10611,17757
LR_43,LinearModel_r42,84850,483,6663,10611,17757
LR_44,LinearModel_r43,84778,483,6651,10587,17721
LR_45,LinearModel_r44,86458,483,6663,10611,17757
LR_46,LinearModel_r45,84778,481,6663,10609,17753
LR_47,LinearModel_r46,84874,481,6663,10609,17753
LR_48,LinearModel_r47,84922,483,6663,10611,17757
LR_49,LinearModel_r48,86802,481,6663,10609,17753
LR_50,LinearModel_r49,84746,481,6663,10609,17753
LR_51,LinearModel_r50,85906,483,6663,10611,17757
GBM_0,LightGBM_c1,114798,391,6663,24729,31783
GBM_1,LightGBM_c2,127505,407,6651,71069,78127
GBM_2,LightGBM_c3,164337,481,6663,375204,382348
GBM_3,LightGBM_c4,90149,496,6663,74947,82106
GBM_4,LightGBM_r1,131993,496,6663,254686,261845
GBM_5,LightGBM_r2,85049,496,6663,164427,171586
GBM_6,LightGBM_r3,77705,496,6651,12063,19210
GBM_7,LightGBM_r4,93201,496,6663,171641,178800
GBM_8,LightGBM_r5,77625,496,6663,12088,19247
GBM_9,LightGBM_r6,110401,496,6663,51276,58435
GBM_10,LightGBM_r7,96337,496,6663,45235,52394
GBM_11,LightGBM_r8,121761,496,6663,60572,67731
GBM_12,LightGBM_r9,77649,496,6651,12882,20029
GBM_13,LightGBM_r10,79947,497,6663,12476,19636
GBM_14,LightGBM_r11,125355,497,6663,79517,86677
GBM_15,LightGBM_r12,159355,497,6663,418325,425485
GBM_16,LightGBM_r13,77667,497,6663,12091,19251
GBM_17,LightGBM_r14,128731,497,6663,68133,75293
GBM_18,LightGBM_r15,145675,497,6651,264875,272023
GBM_19,LightGBM_r16,140891,497,6663,127453,134613
GBM_20,LightGBM_r17,79675,497,6663,146933,154093
GBM_21,LightGBM_r18,78875,497,6663,12091,19251
GBM_22,LightGBM_r19,78470,497,6663,232057,239217
GBM_23,LightGBM_r20,77816,497,6651,12068,19216
GBM_24,LightGBM_r21,79883,497,6663,12091,19251
GBM_25,LightGBM_r22,77675,497,6663,12091,19251
GBM_26,LightGBM_r23,77723,497,6663,12477,19637
GBM_27,LightGBM_r24,82571,497,6663,12093,19253
GBM_28,LightGBM_r25,77771,497,6663,12091,19251
GBM_29,LightGBM_r26,77723,497,6663,12091,19251
GBM_30,LightGBM_r27,79967,497,6651,35460,42608
GBM_31,LightGBM_r28,78046,497,6663,12091,19251
GBM_32,LightGBM_r29,129571,497,6663,68778,75938
GBM_33,LightGBM_r30,152723,497,6663,100501,107661
GBM_34,LightGBM_r31,89467,497,6663,90815,97975
GBM_35,LightGBM_r32,77771,497,6663,12092,19252
GBM_36,LightGBM_r33,80811,497,6651,272407,279555
GBM_37,LightGBM_r34,123619,497,6663,62191,69351
GBM_38,LightGBM_r35,84163,497,6663,27200,34360
GBM_39,LightGBM_r36,78971,497,6663,12091,19251
GBM_40,LightGBM_r37,106547,497,6663,186364,193524
GBM_41,LightGBM_r38,115795,497,6663,280575,287735
GBM_42,LightGBM_r39,78811,497,6651,12067,19215
GBM_43,LightGBM_r40,78000,497,6663,12091,19251
GBM_44,LightGBM_r41,82251,497,6663,34623,41783
GBM_45,LightGBM_r42,92187,497,6663,45126,52286
GBM_46,LightGBM_r43,77771,497,6663,12091,19251
GBM_47,LightGBM_r44,77723,497,6663,12093,19253
GBM_48,LightGBM_r45,78907,497,6651,12069,19217
GBM_49,LightGBM_r46,77318,497,6663,127388,134548
GBM_50,LightGBM_r47,78835,497,6663,12596,19756
GBM_51,LightGBM_r48,78827,497,6663,12091,19251
GBM_52,LightGBM_r49,106147,497,6663,47325,54485
GBM_53,LightGBM_r50,88459,497,6663,33840,41000
GBM_54,LightGBM_r51,123643,497,6651,62415,69563
GBM_55,LightGBM_r52,130795,497,6663,207034,214194
GBM_56,LightGBM_r53,142163,497,6663,80260,87420
GBM_57,LightGBM_r54,79763,497,6663,34873,42033
GBM_58,LightGBM_r55,110019,497,6663,173405,180565
GBM_59,LightGBM_r56,76639,497,6651,277584,284732
GBM_60,LightGBM_r57,78875,497,6663,12091,19251
GBM_61,LightGBM_r58,84835,497,6663,34665,41825
GBM_62,LightGBM_r59,77723,497,6663,12092,19252
GBM_63,LightGBM_r60,137763,497,6663,89091,96251
GBM_64,LightGBM_r61,116683,497,6663,195358,202518
GBM_65,LightGBM_r62,77651,497,6651,12068,19216
GBM_66,LightGBM_r63,89795,497,6663,40878,48038
GBM_67,LightGBM_r64,103259,497,6663,61979,69139
GBM_68,LightGBM_r65,154411,497,6663,108233,115393
GBM_69,LightGBM_r66,78771,497,6663,12091,19251
GBM_70,LightGBM_r67,86763,497,6663,121110,128270
GBM_71,LightGBM_r68,77707,497,6651,12068,19216
GBM_72,LightGBM_r69,78827,497,6663,12093,19253
GBM_73,LightGBM_r70,77327,497,6663,127825,134985
GBM_74,LightGBM_r71,97883,497,6663,48001,55161
GBM_75,LightGBM_r72,78875,497,6663,12093,19253
GBM_76,LightGBM_r73,78883,497,6663,12092,19252
GBM_77,LightGBM_r74,111963,497,6651,122373,129521
GBM_78,LightGBM_r75,85043,497,6663,26667,33827
GBM_79,LightGBM_r76,77783,497,6663,298926,306086
GBM_80,LightGBM_r77,91899,497,6663,210263,217423
GBM_81,LightGBM_r78,102931,497,6663,43531,50691
GBM_82,LightGBM_r79,77103,497,6651,118722,125870
GBM_83,LightGBM_r80,81883,497,6663,12598,19758
GBM_84,LightGBM_r81,78995,497,6663,21305,28465
GBM_85,LightGBM_r82,77771,497,6663,12092,19252
GBM_86,LightGBM_r83,77619,497,6663,12091,19251
GBM_87,LightGBM_r84,78875,497,6663,12092,19252
GBM_88,LightGBM_r85,90083,497,6663,32237,39397
GBM_89,LightGBM_r86,93931,497,6651,35262,42410
GBM_90,LightGBM_r87,111171,497,6663,50908,58068
GBM_91,LightGBM_r88,77723,497,6663,12093,19253
GBM_92,LightGBM_r89,87843,497,6663,53126,60286
GBM_93,LightGBM_r90,78935,497,6663,118263,125423
GBM_94,LightGBM_r91,77814,497,6663,12092,19252
GBM_95,LightGBM_r92,77663,497,6651,112804,119952
GBM_96,LightGBM_r93,122883,497,6663,61507,68667
GBM_97,LightGBM_r94,117707,497,6663,58191,65351
GBM_98,LightGBM_r95,86355,497,6663,185771,192931
GBM_99,LightGBM_r96,78923,497,6663,12091,19251
GBM_100,LightGBM_r97,77667,497,6663,12092,19252
GBM_101,LightGBM_r98,100203,497,6651,231724,238872
GBM_102,LightGBM_r99,79939,497,6663,12092,19252
GBM_103,LightGBM_r100,77729,498,6663,123524,130685
GBM_104,LightGBM_r101,91045,498,6663,214046,221207
GBM_105,LightGBM_r102,78925,498,6663,12096,19257
GBM_106,LightGBM_r103,161373,498,6663,186154,193315
GBM_107,LightGBM_r104,99317,498,6651,48591,55740
GBM_108,LightGBM_r105,78877,498,6663,12096,19257
GBM_109,LightGBM_r106,79239,498,6663,140290,147451
GBM_110,LightGBM_r107,77725,498,6663,12094,19255
GBM_111,LightGBM_r108,78877,498,6663,12094,19255
GBM_112,LightGBM_r109,77757,498,6651,12072,19221
GBM_113,LightGBM_r110,85061,498,6663,25736,32897
GBM_114,LightGBM_r111,127589,498,6663,226721,233882
GBM_115,LightGBM_r112,80789,498,6663,146369,153530
GBM_116,LightGBM_r113,84837,498,6663,25332,32493
GBM_117,LightGBM_r114,78821,498,6663,12600,19761
GBM_118,LightGBM_r115,99877,498,6651,463527,470676
GBM_119,LightGBM_r116,115382,498,6663,143354,150515
GBM_120,LightGBM_r117,80037,498,6663,133136,140297
GBM_121,LightGBM_r118,171213,498,6663,106736,113897
GBM_122,LightGBM_r119,77725,498,6663,12097,19258
GBM_123,LightGBM_r120,158549,498,6663,131578,138739
GBM_124,LightGBM_r121,102557,498,6651,390211,397360
GBM_125,LightGBM_r122,78813,498,6663,32983,40144
GBM_126,LightGBM_r123,171973,498,6663,160553,167714
GBM_127,LightGBM_r124,106949,498,6663,48235,55396
GBM_128,LightGBM_r125,78933,498,6663,12096,19257
GBM_129,LightGBM_r126,78957,498,6651,12071,19220
GBM_130,LightGBM_r127,140941,498,6663,79405,86566
GBM_131,LightGBM_r128,91173,498,6663,33669,40830
GBM_132,LightGBM_r129,78781,498,6663,12095,19256
GBM_133,LightGBM_r130,77773,498,6663,12095,19256
GBM_134,LightGBM_r131,90133,498,6663,44320,51481
GBM_135,LightGBM_r132,79005,498,6663,12095,19256
GBM_136,LightGBM_r133,116325,498,6651,149868,157017
GBM_137,LightGBM_r134,78565,498,6663,17682,24843
GBM_138,LightGBM_r135,78877,498,6663,12096,19257
GBM_139,LightGBM_r136,77725,498,6663,12097,19258
GBM_140,LightGBM_r137,77773,498,6663,12096,19257
GBM_141,LightGBM_r138,115029,498,6663,53459,60620
GBM_142,LightGBM_r139,88445,498,6651,30454,37603
GBM_143,LightGBM_r140,78089,498,6663,113128,120289
GBM_144,LightGBM_r141,95509,498,6663,40060,47221
GBM_145,LightGBM_r142,93731,498,6663,57670,64831
GBM_146,LightGBM_r143,77793,498,6663,142166,149327
GBM_147,LightGBM_r144,78781,498,6663,12096,19257
GBM_148,LightGBM_r145,127597,498,6651,107930,115079
GBM_149,LightGBM_r146,78052,498,6663,12095,19256
GBM_150,LightGBM_r147,89821,498,6663,12095,19256
GBM_151,LightGBM_r148,149458,498,6663,12095,19256
GBM_152,LightGBM_r149,77177,498,6663,339454,346615
GBM_153,LightGBM_r150,173845,498,6663,151821,158982
GBM_154,LightGBM_r151,89517,498,6651,41397,48546
GBM_155,LightGBM_r152,93621,498,6663,36081,43242
GBM_156,LightGBM_r153,100989,498,6663,41747,48908
GBM_157,LightGBM_r154,135893,498,6663,89809,96970
GBM_158,LightGBM_r155,141511,498,6663,79476,86637
GBM_159,LightGBM_r156,117029,498,6663,62246,69407
GBM_160,LightGBM_r157,77661,498,6651,12071,19220
GBM_161,LightGBM_r158,85333,498,6663,26070,33231
GBM_162,LightGBM_r159,79805,498,6663,32830,39991
GBM_163,LightGBM_r160,77629,498,6663,12094,19255
GBM_164,LightGBM_r161,164845,498,6663,192765,199926
GBM_165,LightGBM_r162,108837,498,6663,142482,149643
GBM_166,LightGBM_r163,77757,498,6651,12072,19221
GBM_167,LightGBM_r164,80821,498,6663,155667,162828
GBM_168,LightGBM_r165,153453,498,6663,111802,118963
GBM_169,LightGBM_r166,106053,498,6663,47455,54616
GBM_170,LightGBM_r167,77725,498,6663,12095,19256
GBM_171,LightGBM_r168,80445,498,6663,162102,169263
GBM_172,LightGBM_r169,144061,498,6651,217530,224679
GBM_173,LightGBM_r170,89077,498,6663,35571,42732
GBM_174,LightGBM_r171,148901,498,6663,105043,112204
GBM_175,LightGBM_r172,109677,498,6663,57396,64557
GBM_176,LightGBM_r173,90941,498,6663,33141,40302
GBM_177,LightGBM_r174,85125,498,6651,23892,31041
GBM_178,LightGBM_r175,115853,498,6663,340415,347576
GBM_179,LightGBM_r176,118029,498,6663,57631,64792
GBM_180,LightGBM_r177,141677,498,6663,106634,113795
GBM_181,LightGBM_r178,83317,498,6663,25650,32811
GBM_182,LightGBM_r179,101005,498,6663,86050,93211
GBM_183,LightGBM_r180,86517,498,6651,26037,33186
GBM_184,LightGBM_r181,78517,498,6663,22143,29304
GBM_185,LightGBM_r182,77773,498,6663,12095,19256
GBM_186,LightGBM_r183,80277,498,6663,160507,167668
GBM_187,LightGBM_r184,79117,498,6663,351521,358682
GBM_188,LightGBM_r185,82349,498,6663,25157,32318
GBM_189,LightGBM_r186,78909,498,6651,12073,19222
GBM_190,LightGBM_r187,122949,498,6663,69472,76633
GBM_191,LightGBM_r188,165117,498,6663,253162,260323
GBM_192,LightGBM_r189,132293,498,6663,85780,92941
GBM_193,LightGBM_r190,78933,498,6663,12095,19256
GBM_194,LightGBM_r191,91149,498,6651,39117,46266
GBM_195,LightGBM_r192,101469,498,6663,42018,49179
GBM_196,LightGBM_r193,104533,498,6663,46092,53253
GBM_197,LightGBM_r194,77821,498,6663,12096,19257
GBM_198,LightGBM_r195,79565,498,6663,20554,27715
GBM_199,LightGBM_r196,156277,498,6663,205280,212441
GBM_200,LightGBM_r197,125357,498,6663,91895,99056
GBM_201,LightGBM_r198,83437,498,6651,34098,41247
GBM_202,LightGBM_r199,77717,498,6663,12096,19257
GBM_203,LightGBM_r200,83837,498,6663,70179,77340
KNN_0,KNeighbors_c1,99023,412,6663,20584,27659
KNN_1,KNeighbors_c2,86911,413,6663,20585,27661
KNN_2,KNeighbors_r1,84447,434,6663,20619,27716
KNN_3,KNeighbors_r2,95495,435,6663,20620,27718
KNN_4,KNeighbors_r3,83295,435,6651,20596,27682
KNN_5,KNeighbors_r4,208619,434,6663,12459,19556
KNN_6,KNeighbors_r5,121183,435,6663,20620,27718
KNN_7,KNeighbors_r6,96255,434,6663,20619,27716
KNN_8,KNeighbors_r7,92823,434,6663,20619,27716
KNN_9,KNeighbors_r8,62321,434,6663,12459,19556
KNN_10,KNeighbors_r9,62081,435,6663,12460,19558
KNN_11,KNeighbors_r10,87345,435,6663,20623,27721
KNN_12,KNeighbors_r11,84585,435,6663,20623,27721
KNN_13,KNeighbors_r12,83193,435,6663,20623,27721
KNN_14,KNeighbors_r13,80385,435,6663,20623,27721
KNN_15,KNeighbors_r14,86273,436,6663,20624,27723
KNN_16,KNeighbors_r15,80233,435,6651,20599,27685
KNN_17,KNeighbors_r16,83609,436,6663,20624,27723
KNN_18,KNeighbors_r17,81689,436,6663,20624,27723
KNN_19,KNeighbors_r18,81401,436,6663,20624,27723
KNN_20,KNeighbors_r19,76337,436,6663,20624,27723
KNN_21,KNeighbors_r20,77457,436,6663,20624,27723
KNN_22,KNeighbors_r21,76457,436,6663,20624,27723
KNN_23,KNeighbors_r22,76305,435,6663,20623,27721
KNN_24,KNeighbors_r23,77353,435,6663,20623,27721
KNN_25,KNeighbors_r24,76385,435,6663,20623,27721
KNN_26,KNeighbors_r25,73529,435,6663,20623,27721
KNN_27,KNeighbors_r26,76161,435,6663,20623,27721
KNN_28,KNeighbors_r27,73569,436,6663,20624,27723
KNN_29,KNeighbors_r28,74129,436,6663,20624,27723
KNN_30,KNeighbors_r29,75777,436,6651,20600,27687
KNN_31,KNeighbors_r30,74473,435,6663,20623,27721
KNN_32,KNeighbors_r31,72581,436,6663,20624,27723
KNN_33,KNeighbors_r32,56883,436,6663,12464,19563
KNN_34,KNeighbors_r33,74441,435,6663,20623,27721
KNN_35,KNeighbors_r34,76745,436,6663,20624,27723
KNN_36,KNeighbors_r35,77881,435,6663,20623,27721
KNN_37,KNeighbors_r36,73385,436,6663,20624,27723
KNN_38,KNeighbors_r37,68337,436,6663,20624,27723
KNN_39,KNeighbors_r38,73689,436,6663,20624,27723
KNN_40,KNeighbors_r39,75657,435,6663,20623,27721
KNN_41,KNeighbors_r40,78609,436,6663,20624,27723
KNN_42,KNeighbors_r41,77257,435,6663,20623,27721
KNN_43,KNeighbors_r42,56259,436,6663,12464,19563
KNN_44,KNeighbors_r43,73401,435,6663,20623,27721
KNN_45,KNeighbors_r44,74473,435,6651,20599,27685
KNN_46,KNeighbors_r45,75697,435,6663,20623,27721
KNN_47,KNeighbors_r46,57523,435,6663,12463,19561
KNN_48,KNeighbors_r47,73785,435,6663,20623,27721
KNN_49,KNeighbors_r48,74521,436,6663,20624,27723
KNN_50,KNeighbors_r49,77737,436,6663,20624,27723
KNN_51,KNeighbors_r50,57323,435,6663,12463,19561
FT_TRANSFORMER_0,FTTransformer_c1,1780100,402,6651,8433,15486
FT_TRANSFORMER_1,FTTransformer_c2,1117028,631,6651,0,7282
FT_TRANSFORMER_2,FTTransformer_c3,963805,631,6651,0,7282
FT_TRANSFORMER_3,FTTransformer_c4,656999,631,6663,0,7294
FT_TRANSFORMER_4,FTTransformer_c5,652646,634,6663,0,7297
FT_TRANSFORMER_5,FTTransformer_c6,761954,632,6651,0,7283
FT_TRANSFORMER_6,FTTransformer_c7,1000504,632,6663,0,7295
FASTAI_0,NeuralNetFastAI_c1,472556,394,6651,8948,15993
FASTAI_1,NeuralNetFastAI_r1,352565,480,6651,9046,16177
FASTAI_2,NeuralNetFastAI_r2,432096,482,6663,9072,16217
FASTAI_3,NeuralNetFastAI_r3,447672,481,6651,9046,16178
FASTAI_4,NeuralNetFastAI_r4,329840,476,6651,9042,16169
FASTAI_5,NeuralNetFastAI_r5,389406,477,6651,9043,16171
FASTAI_6,NeuralNetFastAI_r6,371113,476,6651,9042,16169
FASTAI_7,NeuralNetFastAI_r7,352232,481,6651,9047,16179
FASTAI_8,NeuralNetFastAI_r8,394930,481,6651,9047,16179
FASTAI_9,NeuralNetFastAI_r9,320653,477,6651,9043,16171
FASTAI_10,NeuralNetFastAI_r10,378287,477,6651,9046,16174
FASTAI_11,NeuralNetFastAI_r11,365065,481,6651,9049,16181
FASTAI_12,NeuralNetFastAI_r12,382834,482,6651,9051,16184
FASTAI_13,NeuralNetFastAI_r13,373772,482,6663,9075,16220
FASTAI_14,NeuralNetFastAI_r14,368598,482,6651,9050,16183
FASTAI_15,NeuralNetFastAI_r15,361430,480,6651,9049,16180
FASTAI_16,NeuralNetFastAI_r16,387419,479,6651,9047,16177
FASTAI_17,NeuralNetFastAI_r17,403387,483,6663,9076,16222
FASTAI_18,NeuralNetFastAI_r18,343209,478,6651,9047,16176
FASTAI_19,NeuralNetFastAI_r19,356821,483,6651,9052,16186
FASTAI_20,NeuralNetFastAI_r20,421994,477,6651,9046,16174
FASTAI_21,NeuralNetFastAI_r21,421539,482,6651,9051,16184
FASTAI_22,NeuralNetFastAI_r22,427219,482,6651,9051,16184
FASTAI_23,NeuralNetFastAI_r23,349398,482,6651,9051,16184
FASTAI_24,NeuralNetFastAI_r24,338678,481,6651,9050,16182
FASTAI_25,NeuralNetFastAI_r25,367536,482,6651,9051,16184
FASTAI_26,NeuralNetFastAI_r26,377480,482,6651,9051,16184
FASTAI_27,NeuralNetFastAI_r27,383016,483,6651,9052,16186
FASTAI_28,NeuralNetFastAI_r28,393227,480,6651,9049,16180
FASTAI_29,NeuralNetFastAI_r29,351082,481,6651,9049,16181
FASTAI_30,NeuralNetFastAI_r30,283554,482,6651,9051,16184
FASTAI_31,NeuralNetFastAI_r31,373706,482,6651,9051,16184
FASTAI_32,NeuralNetFastAI_r32,374139,481,6651,9050,16182
FASTAI_33,NeuralNetFastAI_r33,378372,482,6663,9075,16220
FASTAI_34,NeuralNetFastAI_r34,405635,482,6651,9050,16183
FASTAI_35,NeuralNetFastAI_r35,417620,481,6651,9049,16181
FASTAI_36,NeuralNetFastAI_r36,370814,477,6651,9046,16174
FASTAI_37,NeuralNetFastAI_r37,375368,483,6651,9052,16186
FASTAI_38,NeuralNetFastAI_r38,336557,476,6651,9044,16171
FASTAI_39,NeuralNetFastAI_r39,384061,482,6663,9075,16220
FASTAI_40,NeuralNetFastAI_r40,427180,481,6651,9049,16181
FASTAI_41,NeuralNetFastAI_r41,350238,480,6651,9049,16180
FASTAI_42,NeuralNetFastAI_r42,417892,483,6651,9052,16186
FASTAI_43,NeuralNetFastAI_r43,457739,483,6651,9052,16186
FASTAI_44,NeuralNetFastAI_r44,393378,481,6651,9050,16182
FASTAI_45,NeuralNetFastAI_r45,320256,477,6663,9070,16210
FASTAI_46,NeuralNetFastAI_r46,400966,481,6651,9050,16182
FASTAI_47,NeuralNetFastAI_r47,488774,480,6651,9049,16180
FASTAI_48,NeuralNetFastAI_r48,434545,478,6651,9047,16176
FASTAI_49,NeuralNetFastAI_r49,403743,483,6651,9052,16186
FASTAI_50,NeuralNetFastAI_r50,274995,477,6651,9046,16174
FASTAI_51,NeuralNetFastAI_r51,378788,482,6663,9075,16220
FASTAI_52,NeuralNetFastAI_r52,343656,477,6651,9045,16173
FASTAI_53,NeuralNetFastAI_r53,414534,482,6651,9051,16184
FASTAI_54,NeuralNetFastAI_r54,298142,481,6651,9050,16182
FASTAI_55,NeuralNetFastAI_r55,321558,482,6651,9051,16184
FASTAI_56,NeuralNetFastAI_r56,115859,477,6651,9046,16174
FASTAI_57,NeuralNetFastAI_r57,318580,477,6651,9045,16173
FASTAI_58,NeuralNetFastAI_r58,452044,482,6651,9051,16184
FASTAI_59,NeuralNetFastAI_r59,406460,483,6651,9052,16186
FASTAI_60,NeuralNetFastAI_r60,318252,477,6663,9069,16209
FASTAI_61,NeuralNetFastAI_r61,366888,476,6651,9044,16171
FASTAI_62,NeuralNetFastAI_r62,351736,483,6651,9052,16186
FASTAI_63,NeuralNetFastAI_r63,377846,480,6651,9049,16180
FASTAI_64,NeuralNetFastAI_r64,420081,483,6651,9052,16186
FASTAI_65,NeuralNetFastAI_r65,332700,478,6663,9071,16212
FASTAI_66,NeuralNetFastAI_r66,331812,478,6651,9047,16176
FASTAI_67,NeuralNetFastAI_r67,414724,483,6651,9052,16186
FASTAI_68,NeuralNetFastAI_r68,375609,480,6663,9073,16216
FASTAI_69,NeuralNetFastAI_r69,381923,481,6651,9049,16181
FASTAI_70,NeuralNetFastAI_r70,342461,481,6651,9050,16182
FASTAI_71,NeuralNetFastAI_r71,372143,483,6651,9052,16186
FASTAI_72,NeuralNetFastAI_r72,370396,477,6651,9046,16174
FASTAI_73,NeuralNetFastAI_r73,436448,477,6651,9046,16174
FASTAI_74,NeuralNetFastAI_r74,335166,481,6651,9050,16182
FASTAI_75,NeuralNetFastAI_r75,398348,478,6651,9047,16176
FASTAI_76,NeuralNetFastAI_r76,338503,477,6651,9045,16173
FASTAI_77,NeuralNetFastAI_r77,304800,480,6663,9073,16216
FASTAI_78,NeuralNetFastAI_r78,423084,483,6651,9052,16186
FASTAI_79,NeuralNetFastAI_r79,385478,481,6651,9050,16182
FASTAI_80,NeuralNetFastAI_r80,359578,479,6651,9047,16177
FASTAI_81,NeuralNetFastAI_r81,429540,482,6651,9051,16184
FASTAI_82,NeuralNetFastAI_r82,355618,480,6651,9049,16180
FASTAI_83,NeuralNetFastAI_r83,374807,482,6651,9051,16184
FASTAI_84,NeuralNetFastAI_r84,364330,482,6651,9051,16184
FASTAI_85,NeuralNetFastAI_r85,297050,481,6651,9050,16182
FASTAI_86,NeuralNetFastAI_r86,374609,482,6663,9075,16220
FASTAI_87,NeuralNetFastAI_r87,395184,481,6651,9049,16181
FASTAI_88,NeuralNetFastAI_r88,322380,478,6651,9047,16176
FASTAI_89,NeuralNetFastAI_r89,404434,482,6651,9051,16184
FASTAI_90,NeuralNetFastAI_r90,394866,483,6651,9052,16186
FASTAI_91,NeuralNetFastAI_r91,396214,480,6651,9049,16180
FASTAI_92,NeuralNetFastAI_r92,340002,478,6651,9047,16176
FASTAI_93,NeuralNetFastAI_r93,357326,480,6651,9049,16180
FASTAI_94,NeuralNetFastAI_r94,425172,482,6663,9075,16220
FASTAI_95,NeuralNetFastAI_r95,414364,482,6651,9050,16183
FASTAI_96,NeuralNetFastAI_r96,442453,483,6663,9076,16222
FASTAI_97,NeuralNetFastAI_r97,297550,480,6651,9049,16180
FASTAI_98,NeuralNetFastAI_r98,319828,477,6663,9070,16210
FASTAI_99,NeuralNetFastAI_r99,363682,481,6651,9050,16182
FASTAI_100,NeuralNetFastAI_r100,346283,483,6651,9055,16189
FASTAI_101,NeuralNetFastAI_r101,437129,483,6651,9055,16189
FASTAI_102,NeuralNetFastAI_r102,380518,481,6651,9053,16185
FASTAI_103,NeuralNetFastAI_r103,398376,482,6651,9054,16187
FASTAI_104,NeuralNetFastAI_r104,399432,481,6651,9053,16185
FASTAI_105,NeuralNetFastAI_r105,393228,482,6651,9054,16187
FASTAI_106,NeuralNetFastAI_r106,348840,482,6651,9054,16187
FASTAI_107,NeuralNetFastAI_r107,392748,483,6663,9079,16225
FASTAI_108,NeuralNetFastAI_r108,384513,483,6651,9054,16188
FASTAI_109,NeuralNetFastAI_r109,419814,483,6651,9054,16188
FASTAI_110,NeuralNetFastAI_r110,385771,483,6651,9055,16189
FASTAI_111,NeuralNetFastAI_r111,340663,482,6651,9054,16187
FASTAI_112,NeuralNetFastAI_r112,320834,479,6651,9051,16181
FASTAI_113,NeuralNetFastAI_r113,325721,477,6651,9048,16176
FASTAI_114,NeuralNetFastAI_r114,334825,478,6663,9074,16215
FASTAI_115,NeuralNetFastAI_r115,352360,481,6651,9053,16185
FASTAI_116,NeuralNetFastAI_r116,373281,483,6651,9055,16189
FASTAI_117,NeuralNetFastAI_r117,348912,483,6651,9055,16189
FASTAI_118,NeuralNetFastAI_r118,346390,482,6651,9054,16187
FASTAI_119,NeuralNetFastAI_r119,379786,484,6663,9080,16227
FASTAI_120,NeuralNetFastAI_r120,416542,483,6651,9054,16188
FASTAI_121,NeuralNetFastAI_r121,351376,482,6663,9078,16223
FASTAI_122,NeuralNetFastAI_r122,420516,482,6651,9054,16187
FASTAI_123,NeuralNetFastAI_r123,393948,482,6651,9054,16187
FASTAI_124,NeuralNetFastAI_r124,340436,482,6651,9054,16187
FASTAI_125,NeuralNetFastAI_r125,393190,483,6651,9055,16189
FASTAI_126,NeuralNetFastAI_r126,353349,483,6651,9055,16189
FASTAI_127,NeuralNetFastAI_r127,384416,481,6651,9053,16185
FASTAI_128,NeuralNetFastAI_r128,384812,480,6651,9051,16182
FASTAI_129,NeuralNetFastAI_r129,418926,483,6651,9055,16189
FASTAI_130,NeuralNetFastAI_r130,428320,481,6651,9053,16185
FASTAI_131,NeuralNetFastAI_r131,443100,481,6651,9052,16184
FASTAI_132,NeuralNetFastAI_r132,366989,481,6651,9053,16185
FASTAI_133,NeuralNetFastAI_r133,399990,483,6651,9055,16189
FASTAI_134,NeuralNetFastAI_r134,392684,483,6651,9055,16189
FASTAI_135,NeuralNetFastAI_r135,381403,481,6651,9053,16185
FASTAI_136,NeuralNetFastAI_r136,339940,482,6651,9054,16187
FASTAI_137,NeuralNetFastAI_r137,390688,480,6651,9051,16182
FASTAI_138,NeuralNetFastAI_r138,291612,482,6651,9053,16186
FASTAI_139,NeuralNetFastAI_r139,346649,484,6651,9056,16191
FASTAI_140,NeuralNetFastAI_r140,426429,483,6651,9054,16188
FASTAI_141,NeuralNetFastAI_r141,377604,482,6651,9054,16187
FASTAI_142,NeuralNetFastAI_r142,371966,484,6651,9056,16191
FASTAI_143,NeuralNetFastAI_r143,417526,483,6663,9079,16225
FASTAI_144,NeuralNetFastAI_r144,409400,483,6651,9055,16189
FASTAI_145,NeuralNetFastAI_r145,364978,483,6651,9054,16188
FASTAI_146,NeuralNetFastAI_r146,355700,483,6651,9055,16189
FASTAI_147,NeuralNetFastAI_r147,318926,477,6651,9048,16176
FASTAI_148,NeuralNetFastAI_r148,349648,482,6663,9078,16223
FASTAI_149,NeuralNetFastAI_r149,350072,481,6651,9053,16185
FASTAI_150,NeuralNetFastAI_r150,340300,482,6651,9054,16187
FASTAI_151,NeuralNetFastAI_r151,312701,479,6651,9051,16181
FASTAI_152,NeuralNetFastAI_r152,300217,483,6651,9055,16189
FASTAI_153,NeuralNetFastAI_r153,348028,483,6663,9079,16225
FASTAI_154,NeuralNetFastAI_r154,407764,482,6651,9054,16187
FASTAI_155,NeuralNetFastAI_r155,491674,481,6651,9053,16185
FASTAI_156,NeuralNetFastAI_r156,347272,479,6651,9051,16181
FASTAI_157,NeuralNetFastAI_r157,354380,483,6651,9055,16189
FASTAI_158,NeuralNetFastAI_r158,407161,484,6651,9056,16191
FASTAI_159,NeuralNetFastAI_r159,340678,477,6651,9048,16176
FASTAI_160,NeuralNetFastAI_r160,350305,483,6651,9054,16188
FASTAI_161,NeuralNetFastAI_r161,399438,483,6663,9079,16225
FASTAI_162,NeuralNetFastAI_r162,293038,482,6651,9054,16187
FASTAI_163,NeuralNetFastAI_r163,366674,484,6651,9056,16191
FASTAI_164,NeuralNetFastAI_r164,405092,482,6651,9054,16187
FASTAI_165,NeuralNetFastAI_r165,421038,483,6651,9055,16189
FASTAI_166,NeuralNetFastAI_r166,324090,478,6651,9049,16178
FASTAI_167,NeuralNetFastAI_r167,334208,483,6651,9055,16189
FASTAI_168,NeuralNetFastAI_r168,418646,484,6651,9056,16191
FASTAI_169,NeuralNetFastAI_r169,420792,484,6651,9056,16191
FASTAI_170,NeuralNetFastAI_r170,335300,483,6663,9079,16225
FASTAI_171,NeuralNetFastAI_r171,329368,483,6651,9055,16189
FASTAI_172,NeuralNetFastAI_r172,373409,479,6651,9051,16181
FASTAI_173,NeuralNetFastAI_r173,374492,482,6651,9053,16186
FASTAI_174,NeuralNetFastAI_r174,387710,479,6651,9051,16181
FASTAI_175,NeuralNetFastAI_r175,392784,483,6651,9055,16189
FASTAI_176,NeuralNetFastAI_r176,363883,482,6651,9054,16187
FASTAI_177,NeuralNetFastAI_r177,345876,482,6663,9078,16223
FASTAI_178,NeuralNetFastAI_r178,288680,481,6651,9053,16185
FASTAI_179,NeuralNetFastAI_r179,379758,478,6651,9050,16179
FASTAI_180,NeuralNetFastAI_r180,446883,481,6651,9052,16184
FASTAI_181,NeuralNetFastAI_r181,366010,478,6651,9049,16178
FASTAI_182,NeuralNetFastAI_r182,410432,481,6663,9077,16221
FASTAI_183,NeuralNetFastAI_r183,390209,483,6651,9055,16189
FASTAI_184,NeuralNetFastAI_r184,398953,483,6651,9055,16189
FASTAI_185,NeuralNetFastAI_r185,411477,483,6651,9055,16189
FASTAI_186,NeuralNetFastAI_r186,303328,480,6651,9051,16182
FASTAI_187,NeuralNetFastAI_r187,436894,483,6651,9055,16189
FASTAI_188,NeuralNetFastAI_r188,371463,482,6651,9054,16187
FASTAI_189,NeuralNetFastAI_r189,372426,478,6651,9050,16179
FASTAI_190,NeuralNetFastAI_r190,355580,483,6651,9055,16189
FASTAI_191,NeuralNetFastAI_r191,393100,483,6663,9079,16225
FASTAI_192,NeuralNetFastAI_r192,418391,482,6651,9054,16187
FASTAI_193,NeuralNetFastAI_r193,356428,480,6651,9051,16182
FASTAI_194,NeuralNetFastAI_r194,364927,484,6663,9080,16227
FASTAI_195,NeuralNetFastAI_r195,377869,478,6651,9049,16178
FASTAI_196,NeuralNetFastAI_r196,311305,482,6651,9054,16187
FASTAI_197,NeuralNetFastAI_r197,380918,482,6651,9054,16187
FASTAI_198,NeuralNetFastAI_r198,304881,481,6663,9077,16221
FASTAI_199,NeuralNetFastAI_r199,333416,483,6651,9055,16189
FASTAI_200,NeuralNetFastAI_r200,373178,483,6651,9054,16188
CAT_0,CatBoost_c1,111150,391,6663,61753,68807
CAT_1,CatBoost_r1,65605,520,6651,55137,62308
CAT_2,CatBoost_r2,63387,520,6651,50233,57404
CAT_3,CatBoost_r3,63027,524,6651,140414,147589
CAT_4,CatBoost_r4,61453,520,6651,107594,114765
CAT_5,CatBoost_r5,61589,524,6663,53133,60320
CAT_6,CatBoost_r6,61021,520,6651,74738,81909
CAT_7,CatBoost_r7,61021,524,6651,102662,109837
CAT_8,CatBoost_r8,60917,524,6663,53605,60792
CAT_9,CatBoost_r9,61021,520,6651,1420355,1427526
CAT_10,CatBoost_r10,61023,521,6651,61853,69025
CAT_11,CatBoost_r11,64103,525,6651,51377,58553
CAT_12,CatBoost_r12,58975,525,6663,55249,62437
CAT_13,CatBoost_r13,58911,525,6651,99834,107010
CAT_14,CatBoost_r14,58927,521,6663,203190,210374
CAT_15,CatBoost_r15,58911,521,6651,57965,65137
CAT_16,CatBoost_r16,58735,525,6651,75482,82658
CAT_17,CatBoost_r17,58911,521,6651,62285,69457
CAT_18,CatBoost_r18,58927,525,6663,112770,119958
CAT_19,CatBoost_r19,58911,525,6651,119018,126194
CAT_20,CatBoost_r20,58911,525,6651,72746,79922
CAT_21,CatBoost_r21,58735,525,6651,77618,84794
CAT_22,CatBoost_r22,58927,525,6663,52017,59205
CAT_23,CatBoost_r23,58911,525,6651,52961,60137
CAT_24,CatBoost_r24,58911,521,6651,60245,67417
CAT_25,CatBoost_r25,58927,525,6663,53065,60253
CAT_26,CatBoost_r26,58735,525,6651,51745,58921
CAT_27,CatBoost_r27,58751,525,6663,97186,104374
CAT_28,CatBoost_r28,59598,521,6651,256782,263954
CAT_29,CatBoost_r29,58735,525,6651,52993,60169
CAT_30,CatBoost_r30,60759,525,6651,50721,57897
CAT_31,CatBoost_r31,71911,525,6663,99882,107070
CAT_32,CatBoost_r32,66455,525,6651,99762,106938
CAT_33,CatBoost_r33,64591,525,6651,103938,111114
CAT_34,CatBoost_r34,64567,525,6651,53145,60321
CAT_35,CatBoost_r35,63535,521,6663,1299823,1307007
CAT_36,CatBoost_r36,63519,521,6651,64541,71713
CAT_37,CatBoost_r37,62967,525,6651,46905,54081
CAT_38,CatBoost_r38,62983,525,6663,58481,65669
CAT_39,CatBoost_r39,62967,525,6651,97138,104314
CAT_40,CatBoost_r40,62967,521,6651,91678,98850
CAT_41,CatBoost_r41,62983,525,6663,56073,63261
CAT_42,CatBoost_r42,62967,525,6651,47833,55009
CAT_43,CatBoost_r43,62967,521,6651,537502,544674
CAT_44,CatBoost_r44,62967,521,6651,175038,182210
CAT_45,CatBoost_r45,63086,525,6651,73994,81170
CAT_46,CatBoost_r46,62967,521,6651,54397,61569
CAT_47,CatBoost_r47,62967,521,6651,167094,174266
CAT_48,CatBoost_r48,62967,525,6651,53929,61105
CAT_49,CatBoost_r49,62983,525,6663,58385,65573
CAT_50,CatBoost_r50,62967,521,6651,71453,78625
CAT_51,CatBoost_r51,62967,521,6651,47445,54617
CAT_52,CatBoost_r52,62983,525,6663,111866,119054
CAT_53,CatBoost_r53,62967,521,6651,134782,141954
CAT_54,CatBoost_r54,62823,521,6651,196814,203986
CAT_55,CatBoost_r55,60855,521,6651,145350,152522
CAT_56,CatBoost_r56,61169,521,6651,108822,115994
CAT_57,CatBoost_r57,60855,521,6651,53093,60265
CAT_58,CatBoost_r58,60855,525,6651,86202,93378
CAT_59,CatBoost_r59,64519,521,6663,46013,53197
CAT_60,CatBoost_r60,60855,525,6651,76570,83746
CAT_61,CatBoost_r61,59511,525,6651,50201,57377
CAT_62,CatBoost_r62,58927,525,6663,117194,124382
CAT_63,CatBoost_r63,61119,521,6651,83486,90658
CAT_64,CatBoost_r64,58735,525,6651,101690,108866
CAT_65,CatBoost_r65,58807,521,6663,57509,64693
CAT_66,CatBoost_r66,58911,521,6651,76142,83314
CAT_67,CatBoost_r67,60045,521,6651,157566,164738
CAT_68,CatBoost_r68,58791,525,6651,58753,65929
CAT_69,CatBoost_r69,58927,525,6663,47025,54213
CAT_70,CatBoost_r70,58911,521,6651,53445,60617
CAT_71,CatBoost_r71,58791,521,6651,162918,170090
CAT_72,CatBoost_r72,58751,525,6663,128250,135438
CAT_73,CatBoost_r73,58911,521,6651,58141,65313
CAT_74,CatBoost_r74,58911,521,6651,81374,88546
CAT_75,CatBoost_r75,58911,521,6651,54277,61449
CAT_76,CatBoost_r76,58791,525,6651,105538,112714
CAT_77,CatBoost_r77,58807,525,6663,103986,111174
CAT_78,CatBoost_r78,58911,525,6651,398667,405843
CAT_79,CatBoost_r79,58911,525,6651,72618,79794
CAT_80,CatBoost_r80,58791,525,6651,101706,108882
CAT_81,CatBoost_r81,58791,521,6651,120542,127714
CAT_82,CatBoost_r82,58911,525,6651,215227,222403
CAT_83,CatBoost_r83,58911,525,6651,47705,54881
CAT_84,CatBoost_r84,58791,525,6651,53777,60953
CAT_85,CatBoost_r85,58807,525,6663,82842,90030
CAT_86,CatBoost_r86,58911,525,6651,206954,214130
CAT_87,CatBoost_r87,63339,521,6651,81198,88370
CAT_88,CatBoost_r88,60719,521,6651,123166,130338
CAT_89,CatBoost_r89,59287,525,6651,50689,57865
CAT_90,CatBoost_r90,60055,521,6663,1096895,1104079
CAT_91,CatBoost_r91,59287,525,6651,115506,122682
CAT_92,CatBoost_r92,58911,521,6651,336246,343418
CAT_93,CatBoost_r93,58911,521,6651,469367,476539
CAT_94,CatBoost_r94,61119,521,6651,72502,79674
CAT_95,CatBoost_r95,58911,521,6651,102102,109274
CAT_96,CatBoost_r96,58807,525,6663,146210,153398
CAT_97,CatBoost_r97,58735,525,6651,76618,83794
CAT_98,CatBoost_r98,59036,525,6651,51801,58977
CAT_99,CatBoost_r99,58911,525,6651,214811,221987
CAT_100,CatBoost_r100,58913,522,6651,61841,69014
CAT_101,CatBoost_r101,59085,522,6651,226322,233495
CAT_102,CatBoost_r102,58793,526,6651,64997,72174
CAT_103,CatBoost_r103,58913,526,6651,102606,109783
CAT_104,CatBoost_r104,58929,522,6663,142618,149803
CAT_105,CatBoost_r105,58913,526,6651,369062,376239
CAT_106,CatBoost_r106,58737,526,6651,217182,224359
CAT_107,CatBoost_r107,58737,526,6651,99766,106943
CAT_108,CatBoost_r108,58913,522,6651,979850,987023
CAT_109,CatBoost_r109,58913,526,6651,74310,81487
CAT_110,CatBoost_r110,58929,526,6663,384886,392075
CAT_111,CatBoost_r111,58913,526,6651,170382,177559
CAT_112,CatBoost_r112,58913,526,6651,102646,109823
CAT_113,CatBoost_r113,58913,526,6651,47661,54838
CAT_114,CatBoost_r114,58929,526,6663,62709,69898
CAT_115,CatBoost_r115,63073,522,6651,226482,233655
CAT_116,CatBoost_r116,58913,526,6651,99558,106735
CAT_117,CatBoost_r117,58793,522,6651,64913,72086
CAT_118,CatBoost_r118,58753,522,6663,346346,353531
CAT_119,CatBoost_r119,58913,526,6651,96990,104167
CAT_120,CatBoost_r120,58929,526,6663,99742,106931
CAT_121,CatBoost_r121,58913,526,6651,50821,57998
CAT_122,CatBoost_r122,58737,522,6651,45793,52966
CAT_123,CatBoost_r123,58809,522,6663,88946,96131
CAT_124,CatBoost_r124,58913,526,6651,91262,98439
CAT_125,CatBoost_r125,61121,522,6651,61977,69150
CAT_126,CatBoost_r126,58913,526,6651,53845,61022
CAT_127,CatBoost_r127,58753,526,6663,54093,61282
CAT_128,CatBoost_r128,58913,522,6651,144122,151295
CAT_129,CatBoost_r129,58913,522,6651,155034,162207
CAT_130,CatBoost_r130,58913,522,6651,50241,57414
CAT_131,CatBoost_r131,58913,522,6651,68617,75790
CAT_132,CatBoost_r132,58929,522,6663,71369,78554
CAT_133,CatBoost_r133,58913,526,6651,102694,109871
CAT_134,CatBoost_r134,59415,522,6651,314554,321727
CAT_135,CatBoost_r135,58737,526,6651,76054,83231
CAT_136,CatBoost_r136,58913,526,6651,53477,60654
CAT_137,CatBoost_r137,58929,526,6663,66685,73874
CAT_138,CatBoost_r138,58913,526,6651,56605,63782
CAT_139,CatBoost_r139,58913,526,6651,49453,56630
CAT_140,CatBoost_r140,58809,522,6663,62041,69226
CAT_141,CatBoost_r141,58737,526,6651,51517,58694
CAT_142,CatBoost_r142,58913,522,6651,124434,131607
CAT_143,CatBoost_r143,58913,526,6651,87902,95079
CAT_144,CatBoost_r144,58809,522,6663,154554,161739
CAT_145,CatBoost_r145,58793,522,6651,81482,88655
CAT_146,CatBoost_r146,58913,526,6651,141830,149007
CAT_147,CatBoost_r147,58913,526,6651,254414,261591
CAT_148,CatBoost_r148,58913,526,6651,105022,112199
CAT_149,CatBoost_r149,58929,526,6663,51805,58994
CAT_150,CatBoost_r150,58913,522,6651,53577,60750
CAT_151,CatBoost_r151,58913,526,6651,83270,90447
CAT_152,CatBoost_r152,58753,522,6663,248962,256147
CAT_153,CatBoost_r153,58913,522,6651,55017,62190
CAT_154,CatBoost_r154,58913,522,6651,497370,504543
CAT_155,CatBoost_r155,58913,526,6651,79270,86447
CAT_156,CatBoost_r156,61121,522,6651,66929,74102
CAT_157,CatBoost_r157,58929,522,6663,217546,224731
CAT_158,CatBoost_r158,58793,522,6651,61041,68214
CAT_159,CatBoost_r159,58793,522,6651,68993,76166
CAT_160,CatBoost_r160,61557,522,6651,45937,53110
CAT_161,CatBoost_r161,59297,522,6663,96562,103747
CAT_162,CatBoost_r162,58913,522,6651,144410,151583
CAT_163,CatBoost_r163,58977,526,6651,72030,79207
CAT_164,CatBoost_r164,58913,526,6651,51053,58230
CAT_165,CatBoost_r165,58929,522,6663,1201091,1208276
CAT_166,CatBoost_r166,58913,526,6651,47693,54870
CAT_167,CatBoost_r167,58865,526,6651,118542,125719
CAT_168,CatBoost_r168,58793,522,6651,135562,142735
CAT_169,CatBoost_r169,58913,526,6651,47613,54790
CAT_170,CatBoost_r170,58929,526,6663,651174,658363
CAT_171,CatBoost_r171,58913,526,6651,66621,73798
CAT_172,CatBoost_r172,58929,522,6663,150794,157979
CAT_173,CatBoost_r173,58793,526,6651,109390,116567
CAT_174,CatBoost_r174,58793,522,6651,107802,114975
CAT_175,CatBoost_r175,59121,522,6663,53193,60378
CAT_176,CatBoost_r176,58913,522,6651,48585,55758
CAT_177,CatBoost_r177,58737,526,6651,87254,94431
CAT_178,CatBoost_r178,59121,526,6663,181806,188995
CAT_179,CatBoost_r179,58793,526,6651,52541,59718
CAT_180,CatBoost_r180,58913,522,6651,62049,69222
CAT_181,CatBoost_r181,58929,522,6663,130058,137243
CAT_182,CatBoost_r182,58913,526,6651,368111,375288
CAT_183,CatBoost_r183,59049,526,6651,64565,71742
CAT_184,CatBoost_r184,59445,522,6651,45945,53118
CAT_185,CatBoost_r185,58753,526,6663,65613,72802
CAT_186,CatBoost_r186,58913,522,6651,108282,115455
CAT_187,CatBoost_r187,61121,522,6651,45825,52998
CAT_188,CatBoost_r188,58929,526,6663,112822,120011
CAT_189,CatBoost_r189,58913,522,6651,113338,120511
CAT_190,CatBoost_r190,58913,526,6651,138342,145519
CAT_191,CatBoost_r191,59233,526,6651,97166,104343
CAT_192,CatBoost_r192,58929,526,6663,111590,118779
CAT_193,CatBoost_r193,58737,526,6651,54781,61958
CAT_194,CatBoost_r194,58809,522,6663,247346,254531
CAT_195,CatBoost_r195,58913,522,6651,131290,138463
CAT_196,CatBoost_r196,58913,522,6651,87218,94391
CAT_197,CatBoost_r197,58793,526,6651,52685,59862
CAT_198,CatBoost_r198,58793,526,6651,47733,54910
CAT_199,CatBoost_r199,59345,526,6663,50037,57226
CAT_200,CatBoost_r200,58913,522,6651,61737,68910
