Model,Memory used (bytes),Predictor size (bytes),Learner size (bytes),Models size (bytes),Total deployment size (bytes)
XT_0,12975661,387,6652,1470144,1477183
XT_1,502808,456,6652,256731,263839
XT_2,176462,454,6652,477329,484435
XT_3,178483,454,6652,636336,643442
XT_4,148338,456,6652,168785,175893
XT_5,150114,454,6652,963937,971043
XT_6,122280,454,6652,217759,224865
XT_7,140671,454,6652,124100,131206
XT_8,131218,454,6652,477329,484435
XT_9,139303,454,6652,217759,224865
XT_10,136093,455,6652,124104,131211
XT_11,130713,455,6652,477333,484440
XT_12,137025,457,6652,126220,133329
XT_13,139643,455,6652,1470244,1477351
XT_14,128131,457,6652,126220,133329
XT_15,132836,457,6652,699621,706730
XT_16,144286,457,6652,1089275,1096384
XT_17,115166,457,6652,256735,263844
XT_18,128200,455,6652,963941,971048
XT_19,121669,457,6652,902208,909317
XT_20,137882,455,6652,477333,484440
XT_21,124871,457,6652,699621,706730
XT_22,138216,457,6652,444233,451342
XT_23,140228,457,6652,164789,171898
XT_24,137735,457,6652,451943,459052
XT_25,131352,457,6652,444233,451342
XT_26,127659,455,6652,392095,399202
XT_27,128199,457,6652,126220,133329
XT_28,131531,455,6652,477333,484440
XT_29,134976,455,6652,217763,224870
XT_30,117377,455,6652,392095,399202
XT_31,135187,457,6652,527242,534351
XT_32,131121,457,6652,1274742,1281851
XT_33,564945,455,6652,636340,643447
XT_34,161587,457,6652,126220,133329
XT_35,160718,457,6652,699621,706730
XT_36,149030,457,6652,540941,548050
XT_37,151428,457,6652,527242,534351
XT_38,140002,457,6652,696741,703850
XT_39,141915,457,6652,936137,943246
XT_40,124132,457,6652,168789,175898
XT_41,136720,457,6652,699621,706730
XT_42,132803,457,6652,1174724,1181833
XT_43,129910,455,6652,477333,484440
XT_44,135736,457,6652,126220,133329
XT_45,139063,455,6652,636340,643447
XT_46,134445,457,6652,699621,706730
XT_47,131330,457,6652,126220,133329
XT_48,138978,457,6652,699621,706730
XT_49,126807,455,6652,1470244,1477351
XT_50,126494,457,6652,168789,175898
XT_51,130917,455,6652,124104,131211
XT_52,137363,455,6652,217763,224870
XT_53,120222,455,6652,146833,153940
XT_54,139816,457,6652,126220,133329
XT_55,137538,455,6652,146833,153940
XT_56,135874,455,6652,636340,643447
XT_57,128484,455,6652,146833,153940
XT_58,130408,455,6652,124104,131211
XT_59,133667,455,6652,636340,643447
XT_60,129701,457,6652,164789,171898
XT_61,126885,457,6652,249514,256623
XT_62,123539,457,6652,126220,133329
XT_63,126937,457,6652,168789,175898
XT_64,128359,457,6652,126220,133329
XT_65,132438,457,6652,126220,133329
XT_66,130615,457,6652,444233,451342
XT_67,131631,457,6652,126220,133329
XT_68,130780,455,6652,124104,131211
XT_69,566146,457,6652,699621,706730
XT_70,165112,457,6652,126220,133329
XT_71,158402,455,6652,636340,643447
XT_72,150319,455,6652,217763,224870
XT_73,143581,455,6652,392095,399202
XT_74,143237,455,6652,217763,224870
XT_75,140610,455,6652,124104,131211
XT_76,131776,455,6652,477333,484440
XT_77,135324,455,6652,124104,131211
XT_78,127781,457,6652,1089275,1096384
XT_79,129285,455,6652,124104,131211
XT_80,122505,457,6652,696741,703850
XT_81,135850,455,6652,963941,971048
XT_82,134116,457,6652,696741,703850
XT_83,132666,457,6652,256735,263844
XT_84,129260,457,6652,240340,247449
XT_85,134169,457,6652,936137,943246
XT_86,131129,457,6652,527242,534351
XT_87,129070,455,6652,217763,224870
XT_88,129644,455,6652,636340,643447
XT_89,122799,455,6652,963941,971048
XT_90,128246,455,6652,146833,153940
XT_91,126394,455,6652,392095,399202
XT_92,129785,455,6652,477333,484440
XT_93,118908,457,6652,126220,133329
XT_94,126198,455,6652,124104,131211
XT_95,128050,457,6652,423551,430660
XT_96,125782,455,6652,392095,399202
XT_97,125923,455,6652,146833,153940
XT_98,122816,457,6652,696741,703850
XT_99,127472,457,6652,550429,557538
XT_100,119217,456,6652,217767,224875
XT_101,121124,456,6652,217767,224875
XT_102,115046,458,6652,126224,133334
XT_103,123861,458,6652,451947,459057
XT_104,124061,456,6652,477337,484445
XT_105,569003,458,6652,699625,706735
XT_106,171646,458,6652,126224,133334
XT_107,155662,458,6652,126224,133334
XT_108,149255,456,6652,217767,224875
XT_109,143095,456,6652,1470248,1477356
XT_110,134731,458,6652,527246,534356
XT_111,134117,458,6652,157913,165023
XT_112,130509,456,6652,1470248,1477356
XT_113,131854,456,6652,124108,131216
XT_114,126234,458,6652,936141,943251
XT_115,137800,458,6652,696745,703855
XT_116,123837,458,6652,126224,133334
XT_117,133051,456,6652,392099,399207
XT_118,126539,458,6652,126224,133334
XT_119,129788,456,6652,963945,971053
XT_120,126964,456,6652,963945,971053
XT_121,135256,458,6652,126224,133334
XT_122,136628,458,6652,164793,171903
XT_123,116244,456,6652,146837,153945
XT_124,132896,456,6652,124108,131216
XT_125,120690,458,6652,451947,459057
XT_126,128046,456,6652,963945,971053
XT_127,143589,458,6652,451947,459057
XT_128,140020,456,6652,124108,131216
XT_129,136267,458,6652,444237,451347
XT_130,135204,456,6652,477337,484445
XT_131,138598,458,6652,699625,706735
XT_132,131129,456,6652,636344,643452
XT_133,132766,456,6652,392099,399207
XT_134,129096,458,6652,1274746,1281856
XT_135,133763,456,6652,392099,399207
XT_136,126209,458,6652,126224,133334
XT_137,136096,458,6652,451947,459057
XT_138,137560,458,6652,126224,133334
XT_139,130347,458,6652,249518,256628
XT_140,137021,456,6652,124108,131216
XT_141,555414,458,6652,550433,557543
XT_142,168144,458,6652,550433,557543
XT_143,161640,456,6652,477337,484445
XT_144,134716,458,6652,1089279,1096389
XT_145,144033,456,6652,146837,153945
XT_146,152719,456,6652,477337,484445
XT_147,141612,458,6652,126224,133334
XT_148,142803,456,6652,1470248,1477356
XT_149,138591,458,6652,936141,943251
XT_150,140425,458,6652,696745,703855
XT_151,135697,456,6652,963945,971053
XT_152,136728,458,6652,444237,451347
XT_153,140668,456,6652,392099,399207
XT_154,138660,456,6652,392099,399207
XT_155,135459,456,6652,124108,131216
XT_156,137595,458,6652,126224,133334
XT_157,132671,458,6652,688265,695375
XT_158,136377,458,6652,1274746,1281856
XT_159,133793,458,6652,126224,133334
XT_160,127650,456,6652,217767,224875
XT_161,131792,458,6652,126224,133334
XT_162,137362,458,6652,696745,703855
XT_163,122254,458,6652,240344,247454
XT_164,134230,458,6652,444237,451347
XT_165,140135,458,6652,688265,695375
XT_166,135254,456,6652,1470248,1477356
XT_167,132235,456,6652,636344,643452
XT_168,125733,456,6652,1470248,1477356
XT_169,144367,458,6652,126224,133334
XT_170,133209,456,6652,217767,224875
XT_171,135075,456,6652,477337,484445
XT_172,116579,458,6652,550433,557543
XT_173,128113,456,6652,146837,153945
XT_174,129059,458,6652,168793,175903
XT_175,139657,458,6652,240344,247454
XT_176,142379,458,6652,444237,451347
XT_177,570137,458,6652,936141,943251
XT_178,169690,458,6652,540945,548055
XT_179,161204,458,6652,240344,247454
XT_180,145126,456,6652,124108,131216
XT_181,143529,456,6652,146837,153945
XT_182,142881,456,6652,217767,224875
XT_183,144745,458,6652,540945,548055
XT_184,136451,458,6652,527246,534356
XT_185,135502,458,6652,423555,430665
XT_186,123317,456,6652,124108,131216
XT_187,135536,458,6652,126224,133334
XT_188,142232,458,6652,126224,133334
XT_189,139067,456,6652,636344,643452
XT_190,144719,456,6652,124108,131216
XT_191,132891,458,6652,936141,943251
XT_192,140524,456,6652,146837,153945
XT_193,136508,456,6652,477337,484445
XT_194,137155,458,6652,696745,703855
XT_195,136960,458,6652,1174728,1181838
XT_196,130111,458,6652,696745,703855
XT_197,132681,458,6652,1089279,1096389
XT_198,134167,458,6652,451947,459057
XT_199,133187,456,6652,636344,643452
XT_200,139226,458,6652,126224,133334
XGB_0,1251743,391,6652,8578,15621
XGB_1,118747,417,6652,8607,15676
XGB_2,101677,414,6664,8142,15220
XGB_3,100994,439,6652,8147,15238
XGB_4,110766,509,6664,8762,15935
XGB_5,109692,509,6664,8762,15935
XGB_6,109845,509,6652,8738,15899
XGB_7,105550,509,6664,8762,15935
XGB_8,117031,509,6652,8249,15410
XGB_9,104702,509,6664,8762,15935
XGB_10,104306,509,6664,8762,15935
XGB_11,103122,509,6652,8738,15899
XGB_12,119590,509,6664,8273,15446
XGB_13,108258,510,6652,8742,15904
XGB_14,103494,510,6664,8766,15940
XGB_15,118180,510,6664,8277,15451
XGB_16,105595,510,6652,8742,15904
XGB_17,103023,510,6664,8766,15940
XGB_18,103481,510,6664,8766,15940
XGB_19,103532,510,6652,8742,15904
XGB_20,103534,510,6664,8766,15940
XGB_21,101953,510,6664,8766,15940
XGB_22,103172,510,6652,8742,15904
XGB_23,101720,510,6664,8766,15940
XGB_24,103257,510,6664,8766,15940
XGB_25,107176,510,6652,8742,15904
XGB_26,102727,510,6664,8766,15940
XGB_27,118379,510,6664,8277,15451
XGB_28,122681,510,6652,8253,15415
XGB_29,120223,510,6664,8277,15451
XGB_30,121197,510,6652,8253,15415
XGB_31,118994,510,6664,8277,15451
XGB_32,106679,510,6652,8742,15904
XGB_33,102934,510,6664,8766,15940
XGB_34,103694,510,6664,8766,15940
XGB_35,103166,510,6652,8742,15904
XGB_36,102906,510,6664,8766,15940
XGB_37,94278,510,6664,8766,15940
XGB_38,113316,510,6652,8742,15904
XGB_39,88700,510,6664,8277,15451
XGB_40,90293,510,6652,8253,15415
XGB_41,109647,510,6664,8766,15940
XGB_42,110869,510,6652,8742,15904
XGB_43,116053,510,6664,8766,15940
XGB_44,109976,510,6664,8766,15940
XGB_45,110108,510,6652,8742,15904
XGB_46,109179,510,6664,8766,15940
XGB_47,87391,510,6664,8277,15451
XGB_48,110050,510,6652,8742,15904
XGB_49,87860,510,6664,8277,15451
XGB_50,110494,510,6664,8766,15940
XGB_51,109445,510,6652,8742,15904
XGB_52,109207,510,6664,8766,15940
XGB_53,111016,510,6664,8766,15940
XGB_54,101343,510,6652,8253,15415
XGB_55,87516,510,6664,8277,15451
XGB_56,123161,510,6652,8253,15415
XGB_57,109895,510,6664,8766,15940
XGB_58,122231,510,6664,8277,15451
XGB_59,108847,510,6652,8742,15904
XGB_60,121092,510,6664,8277,15451
XGB_61,118660,510,6652,8253,15415
XGB_62,118415,510,6664,8277,15451
XGB_63,103559,510,6664,8766,15940
XGB_64,103277,510,6652,8742,15904
XGB_65,117564,510,6664,8277,15451
XGB_66,108283,510,6652,8742,15904
XGB_67,117051,510,6664,8277,15451
XGB_68,103434,510,6664,8766,15940
XGB_69,104000,510,6652,8742,15904
XGB_70,99981,510,6664,8766,15940
XGB_71,119091,510,6664,8277,15451
XGB_72,106440,510,6652,8742,15904
XGB_73,104811,510,6664,8766,15940
XGB_74,118548,510,6652,8253,15415
XGB_75,106836,510,6664,8766,15940
XGB_76,117428,510,6664,8277,15451
XGB_77,103857,510,6652,8742,15904
XGB_78,102281,510,6664,8766,15940
XGB_79,103959,510,6652,8742,15904
XGB_80,100717,510,6664,8766,15940
XGB_81,118191,510,6664,8277,15451
XGB_82,105570,510,6652,8742,15904
XGB_83,117869,510,6664,8277,15451
XGB_84,103935,510,6652,8742,15904
XGB_85,103654,510,6664,8766,15940
XGB_86,117483,510,6664,8277,15451
XGB_87,105340,510,6652,8742,15904
XGB_88,103741,510,6664,8766,15940
XGB_89,117033,510,6652,8253,15415
XGB_90,120800,510,6664,8277,15451
XGB_91,104257,510,6652,8742,15904
XGB_92,102845,510,6664,8766,15940
XGB_93,105894,510,6664,8766,15940
XGB_94,114999,510,6652,8253,15415
XGB_95,119467,510,6664,8277,15451
XGB_96,118870,510,6664,8277,15451
XGB_97,102987,510,6652,8742,15904
XGB_98,102658,510,6664,8766,15940
XGB_99,103188,510,6652,8742,15904
XGB_100,118513,510,6664,8277,15451
XGB_101,121127,510,6664,8277,15451
XGB_102,118941,510,6652,8253,15415
XGB_103,102802,511,6664,8770,15945
XGB_104,118681,511,6652,8257,15420
XGB_105,127778,511,6664,8281,15456
XGB_106,109313,511,6664,8770,15945
XGB_107,117410,511,6652,8257,15420
XGB_108,106559,511,6664,8770,15945
XGB_109,117519,511,6664,8281,15456
XGB_110,104581,511,6652,8746,15909
XGB_111,102840,511,6664,8770,15945
XGB_112,117503,511,6652,8257,15420
XGB_113,105813,511,6664,8770,15945
XGB_114,117031,511,6664,8281,15456
XGB_115,119282,511,6652,8257,15420
XGB_116,118558,511,6664,8281,15456
XGB_117,118362,511,6652,8257,15420
XGB_118,119230,511,6664,8281,15456
XGB_119,104689,511,6664,8770,15945
XGB_120,102259,511,6652,8746,15909
XGB_121,118570,511,6664,8281,15456
XGB_122,122033,511,6652,8257,15420
XGB_123,118887,511,6664,8281,15456
XGB_124,120549,511,6664,8281,15456
XGB_125,119281,511,6652,8257,15420
XGB_126,118913,511,6664,8281,15456
XGB_127,103462,511,6652,8746,15909
XGB_128,102221,511,6664,8770,15945
XGB_129,100112,511,6664,8770,15945
XGB_130,117335,511,6652,8257,15420
XGB_131,107327,511,6664,8770,15945
XGB_132,117697,511,6664,8281,15456
XGB_133,103374,511,6652,8746,15909
XGB_134,117500,511,6664,8281,15456
XGB_135,106166,511,6652,8746,15909
XGB_136,118437,511,6664,8281,15456
XGB_137,105315,511,6664,8770,15945
XGB_138,104130,511,6652,8746,15909
XGB_139,117630,511,6664,8281,15456
XGB_140,122114,511,6652,8746,15909
XGB_141,106282,511,6664,8770,15945
XGB_142,117927,511,6664,8281,15456
XGB_143,103115,511,6652,8746,15909
XGB_144,108919,511,6664,8770,15945
XGB_145,117396,511,6664,8281,15456
XGB_146,123912,511,6652,8257,15420
XGB_147,104201,511,6664,8770,15945
XGB_148,117229,511,6664,8281,15456
XGB_149,121162,511,6652,8257,15420
XGB_150,107615,511,6664,8770,15945
XGB_151,103670,511,6652,8746,15909
XGB_152,105214,511,6664,8770,15945
XGB_153,115892,511,6664,8281,15456
XGB_154,106268,511,6652,8746,15909
XGB_155,118756,511,6664,8281,15456
XGB_156,104853,511,6652,8746,15909
XGB_157,103921,511,6664,8770,15945
XGB_158,102886,511,6664,8770,15945
XGB_159,103858,511,6652,8746,15909
XGB_160,116089,511,6664,8281,15456
XGB_161,107243,511,6652,8746,15909
XGB_162,119284,511,6664,8281,15456
XGB_163,104539,511,6664,8770,15945
XGB_164,102875,511,6652,8746,15909
XGB_165,118930,511,6664,8281,15456
XGB_166,106181,511,6652,8746,15909
XGB_167,117033,511,6664,8281,15456
XGB_168,105067,511,6664,8770,15945
XGB_169,103349,511,6652,8746,15909
XGB_170,104122,511,6664,8770,15945
XGB_171,115119,511,6664,8281,15456
XGB_172,120375,511,6652,8257,15420
XGB_173,104707,511,6664,8770,15945
XGB_174,117382,511,6652,8257,15420
XGB_175,105016,511,6664,8770,15945
XGB_176,101902,511,6664,8770,15945
XGB_177,119178,511,6652,8257,15420
XGB_178,107631,511,6664,8770,15945
XGB_179,103207,511,6664,8770,15945
XGB_180,103744,511,6652,8746,15909
XGB_181,102670,511,6664,8770,15945
XGB_182,102348,511,6652,8746,15909
XGB_183,100842,511,6664,8770,15945
XGB_184,112493,511,6664,8281,15456
XGB_185,90434,511,6652,8257,15420
XGB_186,89227,511,6664,8281,15456
XGB_187,111989,511,6652,8746,15909
XGB_188,109767,511,6664,8770,15945
XGB_189,89040,511,6664,8281,15456
XGB_190,111037,511,6652,8746,15909
XGB_191,87609,511,6664,8281,15456
XGB_192,111673,511,6652,8746,15909
XGB_193,88034,511,6664,8281,15456
XGB_194,110353,511,6664,8770,15945
XGB_195,87953,511,6652,8257,15420
XGB_196,78697,511,6664,8281,15456
XGB_197,122526,511,6652,8257,15420
XGB_198,113561,511,6664,8770,15945
XGB_199,121939,511,6664,8281,15456
XGB_200,109623,511,6652,8746,15909
XGB_201,121851,511,6664,8281,15456
XGB_202,121195,511,6652,8257,15420
XGB_203,109797,511,6664,8770,15945
TABPFN_0,79124673,394,6664,103371254,103378312
TABPFN_1,341078,425,6652,103371267,103378344
TABPFN_2,100851,425,6652,103371267,103378344
RF_0,333924,390,6652,856790,863832
RF_1,173515,456,6652,272588,279696
RF_2,150497,454,6652,534651,541757
RF_3,139977,454,6652,625491,632597
RF_4,130092,456,6652,174393,181501
RF_5,140520,454,6652,738952,746058
RF_6,138506,454,6652,268223,275329
RF_7,121866,454,6652,124105,131211
RF_8,130975,454,6652,534651,541757
RF_9,122950,454,6652,268223,275329
RF_10,136584,455,6652,124109,131216
RF_11,132634,455,6652,534655,541762
RF_12,129078,457,6652,126225,133334
RF_13,132637,455,6652,856885,863992
RF_14,124135,457,6652,126225,133334
RF_15,124982,457,6652,576532,583641
RF_16,130234,457,6652,704266,711375
RF_17,134403,457,6652,272592,279701
RF_18,133172,455,6652,738956,746063
RF_19,126003,457,6652,634331,641440
RF_20,520077,455,6652,534655,541762
RF_21,152103,457,6652,576532,583641
RF_22,144046,457,6652,448398,455507
RF_23,134928,457,6652,174234,181343
RF_24,137911,457,6652,442777,449886
RF_25,135241,457,6652,448398,455507
RF_26,135861,455,6652,461267,468374
RF_27,136801,457,6652,126225,133334
RF_28,132564,455,6652,534655,541762
RF_29,131763,455,6652,268227,275334
RF_30,131405,455,6652,461267,468374
RF_31,139125,457,6652,517303,524412
RF_32,131221,457,6652,779955,787064
RF_33,139346,455,6652,625495,632602
RF_34,138981,457,6652,126225,133334
RF_35,140046,457,6652,576532,583641
RF_36,129530,457,6652,511649,518758
RF_37,128319,457,6652,517303,524412
RF_38,130395,457,6652,556665,563774
RF_39,139643,457,6652,659937,667046
RF_40,129433,457,6652,174397,181506
RF_41,129719,457,6652,576532,583641
RF_42,131715,457,6652,738835,745944
RF_43,124775,455,6652,534655,541762
RF_44,126371,457,6652,126225,133334
RF_45,128157,455,6652,625495,632602
RF_46,136826,457,6652,576532,583641
RF_47,140638,457,6652,126225,133334
RF_48,132023,457,6652,576532,583641
RF_49,125734,455,6652,856885,863992
RF_50,127086,457,6652,174397,181506
RF_51,132089,455,6652,124109,131216
RF_52,130943,455,6652,268227,275334
RF_53,128661,455,6652,172118,179225
RF_54,122703,457,6652,126225,133334
RF_55,130634,455,6652,172118,179225
RF_56,124293,455,6652,625495,632602
RF_57,122911,455,6652,172118,179225
RF_58,129904,455,6652,124109,131216
RF_59,125457,455,6652,625495,632602
RF_60,127581,457,6652,174234,181343
RF_61,128526,457,6652,270032,277141
RF_62,130825,457,6652,126225,133334
RF_63,126207,457,6652,174397,181506
RF_64,127469,457,6652,126225,133334
RF_65,121083,457,6652,126225,133334
RF_66,127104,457,6652,448398,455507
RF_67,120309,457,6652,126225,133334
RF_68,132359,455,6652,124109,131216
RF_69,117313,457,6652,576532,583641
RF_70,129561,457,6652,126225,133334
RF_71,139903,455,6652,625495,632602
RF_72,134003,455,6652,268227,275334
RF_73,133120,455,6652,461267,468374
RF_74,120393,455,6652,268227,275334
RF_75,129645,455,6652,124109,131216
RF_76,120057,455,6652,534655,541762
RF_77,126205,455,6652,124109,131216
RF_78,135971,457,6652,704266,711375
RF_79,129472,455,6652,124109,131216
RF_80,129966,457,6652,556665,563774
RF_81,131954,455,6652,738956,746063
RF_82,125224,457,6652,556665,563774
RF_83,112122,457,6652,272592,279701
RF_84,130439,457,6652,269712,276821
RF_85,134305,457,6652,659937,667046
RF_86,123272,457,6652,517303,524412
RF_87,126799,455,6652,268227,275334
RF_88,133518,455,6652,625495,632602
RF_89,127435,455,6652,738956,746063
RF_90,133928,455,6652,172118,179225
RF_91,130700,455,6652,461267,468374
RF_92,129304,455,6652,534655,541762
RF_93,132126,457,6652,126225,133334
RF_94,117652,455,6652,124109,131216
RF_95,128419,457,6652,454215,461324
RF_96,134959,455,6652,461267,468374
RF_97,232094,455,6652,172118,179225
RF_98,168381,457,6652,556665,563774
RF_99,157053,457,6652,494693,501802
RF_100,147083,456,6652,268231,275339
RF_101,148665,456,6652,268231,275339
RF_102,127015,458,6652,126229,133339
RF_103,191421,458,6652,442781,449891
RF_104,140073,456,6652,534659,541767
RF_105,138105,458,6652,576536,583646
RF_106,125731,458,6652,126229,133339
RF_107,139218,458,6652,126229,133339
RF_108,125359,456,6652,268231,275339
RF_109,141876,456,6652,856889,863997
RF_110,131515,458,6652,517307,524417
RF_111,129655,458,6652,174238,181348
RF_112,130689,456,6652,856889,863997
RF_113,138041,456,6652,124113,131221
RF_114,135134,458,6652,659941,667051
RF_115,124677,458,6652,556669,563779
RF_116,129713,458,6652,126229,133339
RF_117,127622,456,6652,461271,468379
RF_118,128751,458,6652,126229,133339
RF_119,137289,456,6652,738960,746068
RF_120,132484,456,6652,738960,746068
RF_121,128473,458,6652,126229,133339
RF_122,123028,458,6652,174238,181348
RF_123,133013,456,6652,172122,179230
RF_124,138812,456,6652,124113,131221
RF_125,134147,458,6652,442781,449891
RF_126,132921,456,6652,738960,746068
RF_127,127815,458,6652,442781,449891
RF_128,129147,456,6652,124113,131221
RF_129,134570,458,6652,448402,455512
RF_130,127288,456,6652,534659,541767
RF_131,111689,458,6652,576536,583646
RF_132,125841,456,6652,625499,632607
RF_133,120206,456,6652,461271,468379
RF_134,129664,458,6652,779959,787069
RF_135,130208,456,6652,461271,468379
RF_136,134599,458,6652,126229,133339
RF_137,126335,458,6652,442781,449891
RF_138,128865,458,6652,126229,133339
RF_139,132787,458,6652,270036,277146
RF_140,128528,456,6652,124113,131221
RF_141,120441,458,6652,494697,501807
RF_142,127037,458,6652,494697,501807
RF_143,122995,456,6652,534659,541767
RF_144,123018,458,6652,704270,711380
RF_145,128106,456,6652,172122,179230
RF_146,110779,456,6652,534659,541767
RF_147,130078,458,6652,126229,133339
RF_148,132729,456,6652,856889,863997
RF_149,135868,458,6652,659941,667051
RF_150,126563,458,6652,556669,563779
RF_151,128507,456,6652,738960,746068
RF_152,133417,458,6652,448402,455512
RF_153,133809,456,6652,461271,468379
RF_154,127904,456,6652,461271,468379
RF_155,123194,456,6652,124113,131221
RF_156,130780,458,6652,126229,133339
RF_157,129664,458,6652,594791,601901
RF_158,134877,458,6652,779959,787069
RF_159,126875,458,6652,126229,133339
RF_160,134447,456,6652,268231,275339
RF_161,128497,458,6652,126229,133339
RF_162,123851,458,6652,556669,563779
RF_163,128587,458,6652,269716,276826
RF_164,126017,458,6652,448402,455512
RF_165,127604,458,6652,594791,601901
RF_166,109234,456,6652,856889,863997
RF_167,126464,456,6652,625499,632607
RF_168,134126,456,6652,856889,863997
RF_169,128430,458,6652,126229,133339
RF_170,128666,456,6652,268231,275339
RF_171,557554,456,6652,534659,541767
RF_172,165454,458,6652,494697,501807
RF_173,150233,456,6652,172122,179230
RF_174,143991,458,6652,174401,181511
RF_175,146753,458,6652,269716,276826
RF_176,134410,458,6652,448402,455512
RF_177,137408,458,6652,659941,667051
RF_178,130809,458,6652,511653,518763
RF_179,133316,458,6652,269716,276826
RF_180,120129,456,6652,124113,131221
RF_181,130497,456,6652,172122,179230
RF_182,136738,456,6652,268231,275339
RF_183,128143,458,6652,511653,518763
RF_184,129150,458,6652,517307,524417
RF_185,129251,458,6652,454219,461329
RF_186,135248,456,6652,124113,131221
RF_187,124955,458,6652,126229,133339
RF_188,138035,458,6652,126229,133339
RF_189,128049,456,6652,625499,632607
RF_190,132393,456,6652,124113,131221
RF_191,137337,458,6652,659941,667051
RF_192,131968,456,6652,172122,179230
RF_193,135650,456,6652,534659,541767
RF_194,128809,458,6652,556669,563779
RF_195,133578,458,6652,738839,745949
RF_196,125737,458,6652,556669,563779
RF_197,125947,458,6652,704270,711380
RF_198,122292,458,6652,442781,449891
RF_199,134779,456,6652,625499,632607
RF_200,132435,458,6652,126229,133339
NN_TORCH_0,381863,396,6652,221889,228937
NN_TORCH_1,137399,414,6652,234906,241972
NN_TORCH_2,110452,412,6652,88029,95093
NN_TORCH_3,103457,429,6664,93692,100785
NN_TORCH_4,109855,538,6652,526516,533706
NN_TORCH_5,105701,537,6664,19506,26707
NN_TORCH_6,122259,538,6652,164648,171838
NN_TORCH_7,104585,538,6664,27611,34813
NN_TORCH_8,102065,537,6652,24552,31741
NN_TORCH_9,102007,537,6664,559939,567140
NN_TORCH_10,101758,537,6652,21615,28804
NN_TORCH_11,100977,538,6664,183584,190786
NN_TORCH_12,106594,537,6652,162304,169493
NN_TORCH_13,101306,538,6652,225227,232417
NN_TORCH_14,102601,538,6664,336786,343988
NN_TORCH_15,99780,539,6652,18099,25290
NN_TORCH_16,105028,538,6652,195073,202263
NN_TORCH_17,102130,539,6664,22023,29226
NN_TORCH_18,101949,538,6652,203685,210875
NN_TORCH_19,100026,539,6652,231587,238778
NN_TORCH_20,99396,538,6664,55198,62400
NN_TORCH_21,98400,538,6652,19122,26312
NN_TORCH_22,99944,539,6664,26704,33907
NN_TORCH_23,99263,539,6652,17578,24769
NN_TORCH_24,99303,539,6664,24339,31542
NN_TORCH_25,99669,538,6652,575339,582529
NN_TORCH_26,100086,538,6652,21687,28877
NN_TORCH_27,104771,538,6664,381656,388858
NN_TORCH_28,99141,538,6652,173701,180891
NN_TORCH_29,101021,538,6652,84271,91461
NN_TORCH_30,104224,539,6664,89576,96779
NN_TORCH_31,100498,538,6652,495595,502785
NN_TORCH_32,107407,539,6652,1003515,1010706
NN_TORCH_33,104024,538,6652,452147,459337
NN_TORCH_34,99944,538,6652,101176,108366
NN_TORCH_35,98822,539,6664,17606,24809
NN_TORCH_36,100564,539,6652,28968,36159
NN_TORCH_37,102584,539,6664,56378,63581
NN_TORCH_38,103540,539,6652,89483,96674
NN_TORCH_39,101658,538,6664,35954,43156
NN_TORCH_40,102296,538,6652,126659,133849
NN_TORCH_41,101029,538,6652,225577,232767
NN_TORCH_42,99837,538,6652,158181,165371
NN_TORCH_43,99741,538,6664,25855,33057
NN_TORCH_44,103881,539,6664,39988,47191
NN_TORCH_45,101206,538,6652,759215,766405
NN_TORCH_46,101334,538,6664,23176,30378
NN_TORCH_47,99550,538,6652,27376,34566
NN_TORCH_48,98811,538,6652,21983,29173
NN_TORCH_49,100105,538,6664,271909,279111
NN_TORCH_50,104305,538,6664,485037,492239
NN_TORCH_51,100697,539,6652,19635,26826
NN_TORCH_52,100097,539,6652,115812,123003
NN_TORCH_53,99271,538,6664,23228,30430
NN_TORCH_54,100396,540,6652,29810,37002
NN_TORCH_55,100017,538,6652,25051,32241
NN_TORCH_56,101466,539,6664,267317,274520
NN_TORCH_57,99321,538,6664,36071,43273
NN_TORCH_58,98318,538,6652,24427,31617
NN_TORCH_59,102458,538,6664,314606,321808
NN_TORCH_60,103159,539,6652,771860,779051
NN_TORCH_61,103300,539,6652,507064,514255
NN_TORCH_62,102622,538,6664,902666,909868
NN_TORCH_63,104122,538,6652,39972,47162
NN_TORCH_64,100571,539,6652,646150,653341
NN_TORCH_65,98694,538,6664,24399,31601
NN_TORCH_66,108807,538,6664,257285,264487
NN_TORCH_67,107635,539,6652,195690,202881
NN_TORCH_68,101068,539,6652,55691,62882
NN_TORCH_69,99444,538,6652,94275,101465
NN_TORCH_70,101887,539,6664,37207,44410
NN_TORCH_71,103504,538,6652,196820,204010
NN_TORCH_72,101645,538,6664,540533,547735
NN_TORCH_73,105370,538,6652,25366,32556
NN_TORCH_74,101184,539,6664,24755,31958
NN_TORCH_75,98929,538,6652,17049,24239
NN_TORCH_76,98226,539,6664,63394,70597
NN_TORCH_77,99411,538,6652,475754,482944
NN_TORCH_78,99898,538,6664,29052,36254
NN_TORCH_79,100320,539,6652,26472,33663
NN_TORCH_80,100155,538,6664,759239,766441
NN_TORCH_81,100370,539,6652,350446,357637
NN_TORCH_82,105034,538,6664,176197,183399
NN_TORCH_83,102289,538,6652,23984,31174
NN_TORCH_84,98904,538,6652,183893,191083
NN_TORCH_85,100343,539,6664,544731,551934
NN_TORCH_86,101713,539,6652,105771,112962
NN_TORCH_87,98323,538,6664,19874,27076
NN_TORCH_88,102435,538,6652,125012,132202
NN_TORCH_89,100203,539,6664,318970,326173
NN_TORCH_90,101256,539,6652,102515,109706
NN_TORCH_91,104489,539,6652,297302,304493
NN_TORCH_92,103914,539,6652,524325,531516
NN_TORCH_93,100074,539,6664,42573,49776
NN_TORCH_94,100709,539,6652,1035166,1042357
NN_TORCH_95,104744,538,6652,257261,264451
NN_TORCH_96,98473,539,6652,15577,22768
NN_TORCH_97,101601,538,6664,172163,179365
NN_TORCH_98,102609,539,6652,170925,178116
NN_TORCH_99,102726,538,6664,296296,303498
NN_TORCH_100,101036,538,6652,783279,790469
NN_TORCH_101,103594,538,6664,253016,260218
NN_TORCH_102,104708,539,6652,20487,27678
NN_TORCH_103,102177,540,6652,20164,27356
NN_TORCH_104,105206,540,6664,699631,706835
NN_TORCH_105,103976,540,6652,36449,43641
NN_TORCH_106,102949,540,6652,357196,364388
NN_TORCH_107,99660,540,6652,20131,27323
NN_TORCH_108,105205,540,6664,63430,70634
NN_TORCH_109,100544,540,6652,378698,385890
NN_TORCH_110,98898,539,6664,21803,29006
NN_TORCH_111,99112,540,6652,19819,27011
NN_TORCH_112,99673,539,6652,50635,57826
NN_TORCH_113,103153,539,6664,100751,107954
NN_TORCH_114,99659,539,6652,142780,149971
NN_TORCH_115,105898,539,6652,107307,114498
NN_TORCH_116,101650,539,6652,198287,205478
NN_TORCH_117,101509,539,6664,712267,719470
NN_TORCH_118,102361,540,6652,436285,443477
NN_TORCH_119,99370,540,6652,27383,34575
NN_TORCH_120,103534,540,6652,223948,231140
NN_TORCH_121,135925,540,6664,84291,91495
NN_TORCH_122,109435,539,6652,19047,26238
NN_TORCH_123,111991,540,6652,38256,45448
NN_TORCH_124,107995,540,6652,1011110,1018302
NN_TORCH_125,113462,540,6652,34181,41373
NN_TORCH_126,106640,540,6652,30822,38014
NN_TORCH_127,108667,539,6664,312441,319644
NN_TORCH_128,108437,539,6652,93143,100334
NN_TORCH_129,107197,540,6664,215683,222887
NN_TORCH_130,108090,539,6652,777876,785067
NN_TORCH_131,106864,539,6652,136380,143571
NN_TORCH_132,104544,539,6652,96024,103215
NN_TORCH_133,106188,539,6664,91663,98866
NN_TORCH_134,104941,539,6652,27576,34767
NN_TORCH_135,104931,540,6664,622915,630119
NN_TORCH_136,109806,540,6652,285528,292720
NN_TORCH_137,107018,540,6652,356705,363897
NN_TORCH_138,108849,539,6664,377475,384678
NN_TORCH_139,108188,539,6652,233847,241038
NN_TORCH_140,104651,539,6652,22802,29993
NN_TORCH_141,105160,539,6664,16337,23540
NN_TORCH_142,108900,540,6652,171148,178340
NN_TORCH_143,103581,539,6664,53731,60934
NN_TORCH_144,103112,540,6652,95256,102448
NN_TORCH_145,106024,540,6652,815819,823011
NN_TORCH_146,105463,539,6652,773755,780946
NN_TORCH_147,104054,539,6664,62400,69603
NN_TORCH_148,101675,539,6652,107544,114735
NN_TORCH_149,100178,540,6652,275393,282585
NN_TORCH_150,99854,540,6664,19090,26294
NN_TORCH_151,102477,540,6664,424292,431496
NN_TORCH_152,100691,539,6652,101684,108875
NN_TORCH_153,101834,539,6652,170937,178128
NN_TORCH_154,98855,539,6664,226925,234128
NN_TORCH_155,99772,540,6652,282928,290120
NN_TORCH_156,98549,539,6652,402597,409788
NN_TORCH_157,103269,539,6664,820600,827803
NN_TORCH_158,101508,540,6652,52970,60162
NN_TORCH_159,104021,539,6652,416395,423586
NN_TORCH_160,103930,540,6652,895943,903135
NN_TORCH_161,105125,539,6652,238436,245627
NN_TORCH_162,101128,540,6652,43295,50487
NN_TORCH_163,100141,539,6652,902646,909837
NN_TORCH_164,101952,540,6664,43319,50523
NN_TORCH_165,102497,540,6652,87209,94401
NN_TORCH_166,98674,539,6652,23051,30242
NN_TORCH_167,101134,540,6664,23147,30351
NN_TORCH_168,101703,540,6652,21149,28341
NN_TORCH_169,97967,540,6664,26971,34175
NN_TORCH_170,99828,539,6664,23519,30722
NN_TORCH_171,99946,540,6652,208893,216085
NN_TORCH_172,100615,540,6664,30741,37945
NN_TORCH_173,103649,539,6652,305707,312898
NN_TORCH_174,98848,540,6652,85079,92271
NN_TORCH_175,101143,540,6664,261459,268663
NN_TORCH_176,100518,540,6652,24084,31276
NN_TORCH_177,100660,539,6664,481210,488413
NN_TORCH_178,98899,540,6652,15789,22981
NN_TORCH_179,102799,540,6664,217913,225117
NN_TORCH_180,100856,539,6652,54074,61265
NN_TORCH_181,99508,540,6652,18338,25530
NN_TORCH_182,100338,540,6664,72579,79783
NN_TORCH_183,101625,539,6652,124835,132026
NN_TORCH_184,102761,539,6664,124859,132062
NN_TORCH_185,100223,540,6652,18286,25478
NN_TORCH_186,99539,539,6664,544743,551946
NN_TORCH_187,98956,539,6652,217801,224992
NN_TORCH_188,104490,540,6664,314672,321876
NN_TORCH_189,99253,540,6652,633723,640915
NN_TORCH_190,98506,539,6652,243785,250976
NN_TORCH_191,100580,540,6664,289893,297097
NN_TORCH_192,101392,540,6652,602558,609750
NN_TORCH_193,102105,540,6664,544613,551817
NN_TORCH_194,99611,539,6652,26068,33259
NN_TORCH_195,102009,539,6664,508441,515644
NN_TORCH_196,98601,539,6652,161537,168728
NN_TORCH_197,102842,540,6664,165148,172352
NN_TORCH_198,102116,540,6652,23279,30471
NN_TORCH_199,98697,539,6664,20606,27809
NN_TORCH_200,97981,539,6652,27551,34742
NN_TORCH_201,98421,540,6664,292020,299224
NN_TORCH_202,99709,539,6652,311731,318922
NN_TORCH_203,101038,539,6664,125040,132243
LR_0,323917,390,6652,10478,17520
LR_1,109345,414,6652,10497,17563
LR_2,100126,474,6652,10567,17693
LR_3,107652,472,6664,10589,17725
LR_4,92645,480,6652,10581,17713
LR_5,95582,482,6652,10583,17717
LR_6,93649,482,6664,10607,17753
LR_7,90698,480,6664,10605,17749
LR_8,93310,474,6652,10567,17693
LR_9,91421,480,6664,10605,17749
LR_10,90631,472,6664,10589,17725
LR_11,92919,475,6664,10595,17734
LR_12,91970,473,6664,10593,17730
LR_13,90629,475,6664,10595,17734
LR_14,91337,475,6664,10595,17734
LR_15,93093,483,6652,10587,17722
LR_16,88722,483,6664,10611,17758
LR_17,91083,481,6664,10609,17754
LR_18,88088,481,6664,10609,17754
LR_19,93131,481,6664,10609,17754
LR_20,92223,475,6664,10595,17734
LR_21,89967,481,6664,10609,17754
LR_22,91276,481,6664,10609,17754
LR_23,92657,481,6652,10585,17718
LR_24,91305,483,6664,10611,17758
LR_25,90426,481,6664,10609,17754
LR_26,90717,481,6664,10609,17754
LR_27,91990,473,6664,10593,17730
LR_28,91617,483,6664,10611,17758
LR_29,90254,483,6664,10611,17758
LR_30,89845,483,6652,10587,17722
LR_31,91731,473,6664,10593,17730
LR_32,91640,481,6664,10609,17754
LR_33,90590,483,6664,10611,17758
LR_34,92685,475,6664,10595,17734
LR_35,94442,481,6664,10609,17754
LR_36,92871,483,6664,10611,17758
LR_37,93314,483,6652,10587,17722
LR_38,93533,475,6664,10595,17734
LR_39,93302,483,6664,10611,17758
LR_40,91892,481,6664,10609,17754
LR_41,91029,483,6664,10611,17758
LR_42,89978,483,6664,10611,17758
LR_43,92941,483,6664,10611,17758
LR_44,92181,483,6652,10587,17722
LR_45,91538,483,6664,10611,17758
LR_46,91607,481,6664,10609,17754
LR_47,92925,481,6664,10609,17754
LR_48,89146,483,6664,10611,17758
LR_49,91532,481,6664,10609,17754
LR_50,92161,481,6664,10609,17754
LR_51,91384,483,6664,10611,17758
GBM_0,10299591,391,6652,12505,19548
GBM_1,146311,407,6652,39923,46982
GBM_2,92037,481,6664,21726,28871
GBM_3,100344,496,6664,37134,44294
GBM_4,88989,496,6652,18879,26027
GBM_5,109009,496,6664,36863,44023
GBM_6,88821,496,6664,12086,19246
GBM_7,109156,496,6664,34354,41514
GBM_8,88850,496,6652,12063,19211
GBM_9,145771,496,6664,66796,73956
GBM_10,102436,496,6664,32195,39355
GBM_11,91288,496,6664,17916,25076
GBM_12,94859,496,6652,30199,37347
GBM_13,92121,497,6664,12476,19637
GBM_14,139219,497,6664,76487,83648
GBM_15,90452,497,6664,39908,47069
GBM_16,91359,497,6652,12066,19215
GBM_17,89013,497,6664,15784,22945
GBM_18,88118,497,6664,21084,28245
GBM_19,88654,497,6664,14943,22104
GBM_20,94274,497,6652,20740,27889
GBM_21,88272,497,6664,12090,19251
GBM_22,100719,497,6664,45838,52999
GBM_23,90234,497,6664,12091,19252
GBM_24,89200,497,6652,12066,19215
GBM_25,89066,497,6664,12090,19251
GBM_26,149081,497,6664,168850,176011
GBM_27,88451,497,6652,12068,19217
GBM_28,89668,497,6664,12090,19251
GBM_29,88783,497,6664,12090,19251
GBM_30,87609,497,6664,44287,51448
GBM_31,89207,497,6652,12066,19215
GBM_32,89726,497,6664,18993,26154
GBM_33,114250,497,6664,45772,52933
GBM_34,93320,497,6664,21774,28935
GBM_35,88953,497,6652,12067,19216
GBM_36,87349,497,6664,16925,24086
GBM_37,137120,497,6664,60768,67929
GBM_38,180907,497,6664,127722,134883
GBM_39,89041,497,6652,12066,19215
GBM_40,120312,497,6664,45207,52368
GBM_41,138618,497,6664,86400,93561
GBM_42,88515,497,6664,12090,19251
GBM_43,89919,497,6652,12066,19215
GBM_44,88792,497,6664,26471,33632
GBM_45,87803,497,6664,16719,23880
GBM_46,88823,497,6664,12090,19251
GBM_47,88093,497,6652,12068,19217
GBM_48,88392,497,6664,12092,19253
GBM_49,104850,497,6664,31870,39031
GBM_50,89556,497,6664,12597,19758
GBM_51,88385,497,6652,12066,19215
GBM_52,97071,497,6664,24317,31478
GBM_53,101955,497,6664,33915,41076
GBM_54,161643,497,6664,83036,90197
GBM_55,127298,497,6652,50722,57871
GBM_56,91950,497,6664,21176,28337
GBM_57,91065,497,6664,45596,52757
GBM_58,89234,497,6664,32091,39252
GBM_59,146049,497,6652,72522,79671
GBM_60,89275,497,6664,12090,19251
GBM_61,89569,497,6664,20211,27372
GBM_62,89281,497,6664,12091,19252
GBM_63,115613,497,6652,48260,55409
GBM_64,97338,497,6664,61487,68648
GBM_65,88837,497,6664,12091,19252
GBM_66,89272,497,6652,19453,26602
GBM_67,105806,497,6664,42992,50153
GBM_68,116802,497,6664,49679,56840
GBM_69,88814,497,6664,12090,19251
GBM_70,90133,497,6652,60077,67226
GBM_71,90135,497,6664,12091,19252
GBM_72,88933,497,6664,12092,19253
GBM_73,90684,497,6664,19290,26451
GBM_74,87990,497,6652,12685,19834
GBM_75,88338,497,6664,12092,19253
GBM_76,90048,497,6664,12091,19252
GBM_77,92527,497,6664,32813,39974
GBM_78,89170,497,6652,20123,27272
GBM_79,89661,497,6664,25358,32519
GBM_80,127463,497,6664,62801,69962
GBM_81,129507,497,6664,53733,60894
GBM_82,101203,497,6652,29049,36198
GBM_83,181709,497,6664,101520,108681
GBM_84,89624,497,6664,24364,31525
GBM_85,90476,497,6664,12091,19252
GBM_86,89599,497,6652,12066,19215
GBM_87,89802,497,6664,12091,19252
GBM_88,94311,497,6664,20103,27264
GBM_89,100937,497,6664,28926,36087
GBM_90,94009,497,6652,12573,19722
GBM_91,89242,497,6664,12092,19253
GBM_92,95411,497,6664,40978,48139
GBM_93,92137,497,6664,21888,29049
GBM_94,90025,497,6652,12067,19216
GBM_95,104484,497,6664,31510,38671
GBM_96,146912,497,6664,71511,78672
GBM_97,134841,497,6664,58129,65290
GBM_98,125053,497,6652,56355,63504
GBM_99,87819,497,6664,12090,19251
GBM_100,89526,497,6664,12091,19252
GBM_101,124228,497,6664,59679,66840
GBM_102,86648,497,6652,12067,19216
GBM_103,105738,498,6664,30457,37619
GBM_104,114347,498,6664,48541,55703
GBM_105,88851,498,6664,12095,19257
GBM_106,94914,498,6652,28557,35707
GBM_107,89550,498,6664,16788,23950
GBM_108,88170,498,6664,12095,19257
GBM_109,125617,498,6664,50128,57290
GBM_110,87821,498,6652,12069,19219
GBM_111,89222,498,6664,12093,19255
GBM_112,89117,498,6664,12095,19257
GBM_113,90313,498,6664,18287,25449
GBM_114,107910,498,6652,102333,109483
GBM_115,111006,498,6664,37574,44736
GBM_116,156603,498,6664,79370,86532
GBM_117,151129,498,6652,81428,88578
GBM_118,89697,498,6664,20023,27185
GBM_119,88472,498,6664,16882,24044
GBM_120,89205,498,6664,127954,135116
GBM_121,99930,498,6652,26490,33640
GBM_122,87591,498,6664,12096,19258
GBM_123,109805,498,6664,47100,54262
GBM_124,94405,498,6664,33207,40369
GBM_125,89788,498,6652,31102,38252
GBM_126,91998,498,6664,24035,31197
GBM_127,107601,498,6664,34325,41487
GBM_128,88079,498,6652,12071,19221
GBM_129,87114,498,6664,12094,19256
GBM_130,171847,498,6664,91432,98594
GBM_131,100678,498,6664,29039,36201
GBM_132,89246,498,6652,12070,19220
GBM_133,89956,498,6664,12094,19256
GBM_134,88376,498,6664,21965,29127
GBM_135,87449,498,6664,12094,19256
GBM_136,88744,498,6652,25458,32608
GBM_137,105423,498,6664,44353,51515
GBM_138,87988,498,6664,12095,19257
GBM_139,88472,498,6664,12096,19258
GBM_140,89002,498,6652,12071,19221
GBM_141,90133,498,6664,17571,24733
GBM_142,151291,498,6664,74885,82047
GBM_143,101959,498,6664,29642,36804
GBM_144,101223,498,6652,30948,38098
GBM_145,89485,498,6664,14961,22123
GBM_146,88162,498,6664,12711,19873
GBM_147,87690,498,6664,12095,19257
GBM_148,91111,498,6652,216627,223777
GBM_149,87370,498,6664,12094,19256
GBM_150,87149,498,6664,12094,19256
GBM_151,88592,498,6664,12094,19256
GBM_152,88639,498,6652,31218,38368
GBM_153,112125,498,6664,51164,58326
GBM_154,90348,498,6664,14837,21999
GBM_155,102195,498,6664,29340,36502
GBM_156,91241,498,6652,18957,26107
GBM_157,151917,498,6664,72495,79657
GBM_158,248923,498,6664,56311,63473
GBM_159,141758,498,6664,70294,77456
GBM_160,89853,498,6652,12070,19220
GBM_161,88107,498,6664,14370,21532
GBM_162,94730,498,6664,46597,53759
GBM_163,88809,498,6664,12093,19255
GBM_164,99611,498,6652,39598,46748
GBM_165,88640,498,6664,28870,36032
GBM_166,90145,498,6664,12095,19257
GBM_167,103243,498,6664,34143,41305
GBM_168,112459,498,6652,47831,54981
GBM_169,138765,498,6664,61252,68414
GBM_170,87317,498,6664,12094,19256
GBM_171,124152,498,6664,54762,61924
GBM_172,90958,498,6652,31751,38901
GBM_173,91035,498,6664,12710,19872
GBM_174,189049,498,6664,128860,136022
GBM_175,98593,498,6652,28293,35443
GBM_176,184955,498,6664,103663,110825
GBM_177,87835,498,6664,12600,19762
GBM_178,102584,498,6664,136654,143816
GBM_179,92945,498,6652,20744,27894
GBM_180,88517,498,6664,12714,19876
GBM_181,127636,498,6664,62453,69615
GBM_182,87944,498,6664,21710,28872
GBM_183,169805,498,6652,91784,98934
GBM_184,89419,498,6664,20650,27812
GBM_185,88403,498,6664,12094,19256
GBM_186,89062,498,6664,12597,19759
GBM_187,117643,498,6652,98144,105294
GBM_188,88807,498,6664,17069,24231
GBM_189,87275,498,6664,12096,19258
GBM_190,90564,498,6664,12715,19877
GBM_191,91298,498,6652,32039,39189
GBM_192,155965,498,6664,98298,105460
GBM_193,90740,498,6664,12094,19256
GBM_194,123590,498,6652,59313,66463
GBM_195,93645,498,6664,22537,29699
GBM_196,126806,498,6664,51030,58192
GBM_197,87429,498,6664,12095,19257
GBM_198,88560,498,6652,15224,22374
GBM_199,135698,498,6664,126468,133630
GBM_200,98693,498,6664,34685,41847
GBM_201,94519,498,6664,38886,46048
GBM_202,88725,498,6652,12071,19221
GBM_203,103343,498,6664,137963,145125
KNN_0,148487,412,6664,20584,27660
KNN_1,100697,413,6664,20585,27662
KNN_2,96194,434,6664,20619,27717
KNN_3,90846,435,6652,20596,27683
KNN_4,96642,435,6664,20620,27719
KNN_5,229991,434,6664,12459,19557
KNN_6,114443,435,6664,20620,27719
KNN_7,97364,434,6664,20619,27717
KNN_8,81029,434,6664,20619,27717
KNN_9,71319,434,6664,12459,19557
KNN_10,69991,435,6664,12460,19559
KNN_11,89523,435,6652,20599,27686
KNN_12,92879,435,6664,20623,27722
KNN_13,88342,435,6664,20623,27722
KNN_14,91259,435,6664,20623,27722
KNN_15,82555,436,6664,20624,27724
KNN_16,88534,435,6664,20623,27722
KNN_17,87093,436,6664,20624,27724
KNN_18,87904,436,6664,20624,27724
KNN_19,86575,436,6664,20624,27724
KNN_20,86287,436,6652,20600,27688
KNN_21,75071,436,6664,20624,27724
KNN_22,88192,436,6664,20624,27724
KNN_23,84113,435,6664,20623,27722
KNN_24,81716,435,6664,20623,27722
KNN_25,85737,435,6664,20623,27722
KNN_26,85074,435,6664,20623,27722
KNN_27,74771,435,6664,20623,27722
KNN_28,78205,436,6664,20624,27724
KNN_29,82654,436,6652,20600,27688
KNN_30,80025,436,6664,20624,27724
KNN_31,81948,435,6664,20623,27722
KNN_32,81318,436,6664,20624,27724
KNN_33,64217,436,6664,12464,19564
KNN_34,81682,435,6664,20623,27722
KNN_35,81491,436,6664,20624,27724
KNN_36,82986,435,6664,20623,27722
KNN_37,80868,436,6664,20624,27724
KNN_38,82805,436,6652,20600,27688
KNN_39,79023,436,6664,20624,27724
KNN_40,79216,435,6664,20623,27722
KNN_41,79636,436,6664,20624,27724
KNN_42,80933,435,6664,20623,27722
KNN_43,64396,436,6664,12464,19564
KNN_44,80954,435,6664,20623,27722
KNN_45,87174,435,6664,20623,27722
KNN_46,74388,435,6664,20623,27722
KNN_47,64765,435,6652,12439,19526
KNN_48,82645,435,6664,20623,27722
KNN_49,81570,436,6664,20624,27724
KNN_50,83229,436,6664,20624,27724
KNN_51,64918,435,6664,12463,19562
FT_TRANSFORMER_0,123526994,402,6664,8457,15523
FT_TRANSFORMER_1,927633,631,6652,0,7283
FT_TRANSFORMER_2,729212,631,6652,0,7283
FT_TRANSFORMER_3,718587,631,6652,0,7283
FT_TRANSFORMER_4,713676,634,6664,0,7298
FT_TRANSFORMER_5,708808,632,6652,0,7284
FT_TRANSFORMER_6,710059,632,6664,0,7296
FASTAI_0,7891780,394,6652,8948,15994
FASTAI_1,470938,480,6652,9046,16178
FASTAI_2,413543,482,6652,9048,16182
FASTAI_3,444593,481,6652,9046,16179
FASTAI_4,461595,476,6652,9042,16170
FASTAI_5,406534,477,6652,9043,16172
FASTAI_6,408989,476,6652,9042,16170
FASTAI_7,448466,481,6652,9047,16180
FASTAI_8,353686,481,6652,9047,16180
FASTAI_9,407379,477,6652,9043,16172
FASTAI_10,405403,477,6652,9046,16175
FASTAI_11,438796,481,6652,9049,16182
FASTAI_12,401222,482,6652,9051,16185
FASTAI_13,436802,482,6652,9051,16185
FASTAI_14,345166,482,6652,9050,16184
FASTAI_15,370838,480,6652,9049,16181
FASTAI_16,406965,479,6652,9047,16178
FASTAI_17,344445,483,6652,9052,16187
FASTAI_18,340951,478,6652,9047,16177
FASTAI_19,361797,483,6652,9052,16187
FASTAI_20,395456,477,6652,9046,16175
FASTAI_21,360390,482,6652,9051,16185
FASTAI_22,354827,482,6652,9051,16185
FASTAI_23,329778,482,6652,9051,16185
FASTAI_24,342505,481,6652,9050,16183
FASTAI_25,388796,482,6652,9051,16185
FASTAI_26,362652,482,6652,9051,16185
FASTAI_27,399994,483,6652,9052,16187
FASTAI_28,360438,480,6652,9049,16181
FASTAI_29,436539,481,6652,9049,16182
FASTAI_30,448817,482,6652,9051,16185
FASTAI_31,369215,482,6652,9051,16185
FASTAI_32,395297,481,6652,9050,16183
FASTAI_33,394502,482,6652,9051,16185
FASTAI_34,395920,482,6652,9050,16184
FASTAI_35,380268,481,6652,9049,16182
FASTAI_36,391548,477,6652,9046,16175
FASTAI_37,348879,483,6652,9052,16187
FASTAI_38,338643,476,6652,9044,16172
FASTAI_39,363424,482,6652,9051,16185
FASTAI_40,367333,481,6652,9049,16182
FASTAI_41,419230,480,6652,9049,16181
FASTAI_42,413687,483,6652,9052,16187
FASTAI_43,455357,483,6652,9052,16187
FASTAI_44,399567,481,6652,9050,16183
FASTAI_45,415749,477,6652,9046,16175
FASTAI_46,401903,481,6652,9050,16183
FASTAI_47,405818,480,6652,9049,16181
FASTAI_48,352427,478,6652,9047,16177
FASTAI_49,394383,483,6652,9052,16187
FASTAI_50,385642,477,6652,9046,16175
FASTAI_51,449548,482,6652,9051,16185
FASTAI_52,304419,477,6652,9045,16174
FASTAI_53,365623,482,6652,9051,16185
FASTAI_54,418280,481,6652,9050,16183
FASTAI_55,398708,482,6652,9051,16185
FASTAI_56,403971,477,6652,9046,16175
FASTAI_57,384590,477,6652,9045,16174
FASTAI_58,404012,482,6652,9051,16185
FASTAI_59,402344,483,6652,9052,16187
FASTAI_60,432463,477,6652,9045,16174
FASTAI_61,287401,476,6652,9044,16172
FASTAI_62,401282,483,6652,9052,16187
FASTAI_63,361511,480,6652,9049,16181
FASTAI_64,365236,483,6652,9052,16187
FASTAI_65,384130,478,6652,9047,16177
FASTAI_66,380316,478,6652,9047,16177
FASTAI_67,361760,483,6652,9052,16187
FASTAI_68,360898,480,6652,9049,16181
FASTAI_69,356529,481,6652,9049,16182
FASTAI_70,382752,481,6652,9050,16183
FASTAI_71,355062,483,6652,9052,16187
FASTAI_72,316972,477,6652,9046,16175
FASTAI_73,404100,477,6652,9046,16175
FASTAI_74,405080,481,6652,9050,16183
FASTAI_75,385892,478,6652,9047,16177
FASTAI_76,366654,477,6652,9045,16174
FASTAI_77,403833,480,6652,9049,16181
FASTAI_78,384191,483,6652,9052,16187
FASTAI_79,382956,481,6652,9050,16183
FASTAI_80,332053,479,6652,9047,16178
FASTAI_81,340583,482,6652,9051,16185
FASTAI_82,330113,480,6652,9049,16181
FASTAI_83,360099,482,6652,9051,16185
FASTAI_84,373180,482,6652,9051,16185
FASTAI_85,454474,481,6652,9050,16183
FASTAI_86,318038,482,6652,9051,16185
FASTAI_87,429011,481,6652,9049,16182
FASTAI_88,411482,478,6652,9047,16177
FASTAI_89,375657,482,6652,9051,16185
FASTAI_90,450886,483,6652,9052,16187
FASTAI_91,366327,480,6652,9049,16181
FASTAI_92,333927,478,6652,9047,16177
FASTAI_93,386429,480,6652,9049,16181
FASTAI_94,422617,482,6652,9051,16185
FASTAI_95,348469,482,6652,9050,16184
FASTAI_96,372017,483,6652,9052,16187
FASTAI_97,390646,480,6652,9049,16181
FASTAI_98,349022,477,6652,9046,16175
FASTAI_99,379918,481,6652,9050,16183
FASTAI_100,398183,483,6652,9055,16190
FASTAI_101,347861,483,6652,9055,16190
FASTAI_102,389922,481,6652,9053,16186
FASTAI_103,361513,482,6652,9054,16188
FASTAI_104,398026,481,6652,9053,16186
FASTAI_105,367370,482,6652,9054,16188
FASTAI_106,353998,482,6652,9054,16188
FASTAI_107,357775,483,6652,9055,16190
FASTAI_108,370288,483,6652,9054,16189
FASTAI_109,366470,483,6652,9054,16189
FASTAI_110,346737,483,6652,9055,16190
FASTAI_111,351478,482,6652,9054,16188
FASTAI_112,413971,479,6652,9051,16182
FASTAI_113,365531,477,6652,9048,16177
FASTAI_114,373009,478,6652,9050,16180
FASTAI_115,402373,481,6652,9053,16186
FASTAI_116,360501,483,6652,9055,16190
FASTAI_117,358937,483,6652,9055,16190
FASTAI_118,380502,482,6652,9054,16188
FASTAI_119,436908,484,6652,9056,16192
FASTAI_120,400420,483,6652,9054,16189
FASTAI_121,410257,482,6652,9054,16188
FASTAI_122,394667,482,6652,9054,16188
FASTAI_123,409748,482,6652,9054,16188
FASTAI_124,360573,482,6652,9054,16188
FASTAI_125,394169,483,6652,9055,16190
FASTAI_126,362269,483,6652,9055,16190
FASTAI_127,298528,481,6652,9053,16186
FASTAI_128,442259,480,6652,9051,16183
FASTAI_129,441546,483,6652,9055,16190
FASTAI_130,395496,481,6652,9053,16186
FASTAI_131,378824,481,6652,9052,16185
FASTAI_132,346884,481,6652,9053,16186
FASTAI_133,347751,483,6652,9055,16190
FASTAI_134,321101,483,6652,9055,16190
FASTAI_135,407343,481,6652,9053,16186
FASTAI_136,419312,482,6652,9054,16188
FASTAI_137,377946,480,6652,9051,16183
FASTAI_138,381542,482,6652,9053,16187
FASTAI_139,388659,484,6652,9056,16192
FASTAI_140,369538,483,6652,9054,16189
FASTAI_141,350165,482,6652,9054,16188
FASTAI_142,388834,484,6652,9056,16192
FASTAI_143,378010,483,6652,9055,16190
FASTAI_144,430401,483,6652,9055,16190
FASTAI_145,441314,483,6652,9054,16189
FASTAI_146,465243,483,6652,9055,16190
FASTAI_147,468280,477,6652,9048,16177
FASTAI_148,415601,482,6652,9054,16188
FASTAI_149,380992,481,6652,9053,16186
FASTAI_150,356494,482,6652,9054,16188
FASTAI_151,389054,479,6652,9051,16182
FASTAI_152,385543,483,6652,9055,16190
FASTAI_153,363970,483,6652,9055,16190
FASTAI_154,432725,482,6652,9054,16188
FASTAI_155,365147,481,6652,9053,16186
FASTAI_156,393621,479,6652,9051,16182
FASTAI_157,377504,483,6652,9055,16190
FASTAI_158,439204,484,6652,9056,16192
FASTAI_159,316875,477,6652,9048,16177
FASTAI_160,361450,483,6652,9054,16189
FASTAI_161,357416,483,6652,9055,16190
FASTAI_162,356128,482,6652,9054,16188
FASTAI_163,413286,484,6652,9056,16192
FASTAI_164,373676,482,6652,9054,16188
FASTAI_165,419593,483,6652,9055,16190
FASTAI_166,360728,478,6652,9049,16179
FASTAI_167,406405,483,6652,9055,16190
FASTAI_168,407553,484,6652,9056,16192
FASTAI_169,396395,484,6652,9056,16192
FASTAI_170,378768,483,6652,9055,16190
FASTAI_171,351312,483,6652,9055,16190
FASTAI_172,395861,479,6652,9051,16182
FASTAI_173,429605,482,6652,9053,16187
FASTAI_174,347166,479,6652,9051,16182
FASTAI_175,361487,483,6652,9055,16190
FASTAI_176,401270,482,6652,9054,16188
FASTAI_177,366331,482,6652,9054,16188
FASTAI_178,397232,481,6652,9053,16186
FASTAI_179,383620,478,6652,9050,16180
FASTAI_180,363837,481,6652,9052,16185
FASTAI_181,357755,478,6652,9049,16179
FASTAI_182,363191,481,6652,9053,16186
FASTAI_183,419416,483,6652,9055,16190
FASTAI_184,408376,483,6652,9055,16190
FASTAI_185,363150,483,6652,9055,16190
FASTAI_186,415371,480,6652,9051,16183
FASTAI_187,413319,483,6652,9055,16190
FASTAI_188,395908,482,6652,9054,16188
FASTAI_189,431347,478,6652,9050,16180
FASTAI_190,412560,483,6652,9055,16190
FASTAI_191,335572,483,6652,9055,16190
FASTAI_192,355839,482,6652,9054,16188
FASTAI_193,344632,480,6652,9051,16183
FASTAI_194,373124,484,6652,9056,16192
FASTAI_195,397893,478,6652,9049,16179
FASTAI_196,342095,482,6652,9054,16188
FASTAI_197,356274,482,6652,9054,16188
FASTAI_198,309051,481,6652,9053,16186
FASTAI_199,367824,483,6652,9055,16190
FASTAI_200,409322,483,6652,9054,16189
CAT_0,1516140,391,6652,49825,56868
CAT_1,79121,520,6652,62057,69229
CAT_2,73527,520,6652,52505,59677
CAT_3,73897,524,6652,70021,77197
CAT_4,69475,520,6652,47337,54509
CAT_5,69558,524,6652,48677,55853
CAT_6,70208,520,6652,133858,141030
CAT_7,69757,524,6652,79590,86766
CAT_8,68749,524,6652,45189,52365
CAT_9,67812,520,6652,57505,64677
CAT_10,67219,521,6652,95670,102843
CAT_11,67841,525,6652,48217,55394
CAT_12,68172,525,6652,50841,58018
CAT_13,66856,525,6652,69721,76898
CAT_14,67620,521,6652,169598,176771
CAT_15,67549,521,6652,50269,57442
CAT_16,67908,525,6652,47889,55066
CAT_17,67271,521,6652,88422,95595
CAT_18,66766,525,6652,48617,55794
CAT_19,67049,525,6652,48697,55874
CAT_20,67945,525,6652,46953,54130
CAT_21,68344,525,6652,50057,57234
CAT_22,71439,525,6652,51097,58274
CAT_23,68112,525,6652,48305,55482
CAT_24,67987,521,6664,266830,274015
CAT_25,67654,525,6652,53521,60698
CAT_26,66545,525,6652,48233,55410
CAT_27,67317,525,6652,48321,55498
CAT_28,66673,521,6652,53605,60778
CAT_29,67353,525,6652,45681,52858
CAT_30,68352,525,6652,46905,54082
CAT_31,69614,525,6652,123474,130651
CAT_32,67136,525,6652,114866,122043
CAT_33,67851,525,6652,48441,55618
CAT_34,67173,525,6652,53721,60898
CAT_35,67160,521,6652,73062,80235
CAT_36,67127,521,6652,232350,239523
CAT_37,67688,525,6652,45529,52706
CAT_38,66757,525,6652,48833,56010
CAT_39,68498,525,6652,48361,55538
CAT_40,67899,521,6652,46557,53730
CAT_41,67507,525,6664,45105,52294
CAT_42,67007,525,6652,50129,57306
CAT_43,67078,521,6652,52453,59626
CAT_44,67368,521,6652,66413,73586
CAT_45,66982,525,6652,47665,54842
CAT_46,66875,521,6652,307174,314347
CAT_47,67601,521,6652,51957,59130
CAT_48,68062,525,6652,51137,58314
CAT_49,67428,525,6664,48641,55830
CAT_50,67366,521,6652,80262,87435
CAT_51,67309,521,6652,82126,89299
CAT_52,66731,525,6652,258290,265467
CAT_53,68412,521,6652,53957,61130
CAT_54,68321,521,6652,53157,60330
CAT_55,67619,521,6652,51717,58890
CAT_56,68761,521,6652,103646,110819
CAT_57,67526,521,6652,229286,236459
CAT_58,67513,525,6652,57505,64682
CAT_59,67763,521,6652,110262,117435
CAT_60,67761,525,6652,45657,52834
CAT_61,68032,525,6652,50329,57506
CAT_62,67942,525,6652,149282,156459
CAT_63,68444,521,6652,103878,111051
CAT_64,66935,525,6652,81938,89115
CAT_65,68605,521,6652,69957,77130
CAT_66,67554,521,6652,63469,70642
CAT_67,68045,521,6652,217966,225139
CAT_68,68918,525,6652,45449,52626
CAT_69,67600,525,6652,45505,52682
CAT_70,71510,521,6664,91430,98615
CAT_71,68063,521,6652,61357,68530
CAT_72,67339,525,6652,45385,52562
CAT_73,67949,521,6652,50101,57274
CAT_74,68663,521,6652,51813,58986
CAT_75,67548,521,6652,52005,59178
CAT_76,68008,525,6652,69969,77146
CAT_77,67969,525,6652,58241,65418
CAT_78,67739,525,6652,48673,55850
CAT_79,67484,525,6652,46945,54122
CAT_80,67341,525,6652,48585,55762
CAT_81,66796,521,6652,73182,80355
CAT_82,68170,525,6652,46937,54114
CAT_83,68388,525,6652,50153,57330
CAT_84,67361,525,6652,51513,58690
CAT_85,68071,525,6652,57545,64722
CAT_86,67611,525,6652,230578,237755
CAT_87,67876,521,6652,164870,172043
CAT_88,67720,521,6652,88670,95843
CAT_89,68569,525,6652,46897,54074
CAT_90,67121,521,6652,89478,96651
CAT_91,67869,525,6652,50201,57378
CAT_92,69413,521,6652,136758,143931
CAT_93,68651,521,6652,59045,66218
CAT_94,68073,521,6652,110726,117899
CAT_95,68088,521,6652,46917,54090
CAT_96,67973,525,6652,48657,55834
CAT_97,67146,525,6652,45297,52474
CAT_98,67623,525,6652,48177,55354
CAT_99,68230,525,6664,46921,54110
CAT_100,67329,522,6652,56697,63871
CAT_101,68004,522,6652,87402,94576
CAT_102,69021,526,6652,177654,184832
CAT_103,68440,526,6652,50621,57799
CAT_104,68226,522,6652,240922,248096
CAT_105,67678,526,6652,172638,179816
CAT_106,68553,526,6652,69877,77055
CAT_107,67973,526,6652,179150,186328
CAT_108,67596,522,6652,53305,60479
CAT_109,67612,526,6652,166838,174016
CAT_110,68392,526,6652,495590,502768
CAT_111,67326,526,6652,215686,222864
CAT_112,67715,526,6652,50741,57919
CAT_113,67766,526,6652,48805,55983
CAT_114,68781,526,6652,45373,52551
CAT_115,67632,522,6652,53433,60607
CAT_116,67360,526,6652,46213,53391
CAT_117,67777,522,6652,81970,89144
CAT_118,69011,522,6652,180562,187736
CAT_119,68359,526,6652,151318,158496
CAT_120,68344,526,6652,46197,53375
CAT_121,69278,526,6652,48237,55415
CAT_122,68724,522,6652,78954,86128
CAT_123,68361,522,6652,53641,60815
CAT_124,68489,526,6652,170470,177648
CAT_125,68022,522,6652,52025,59199
CAT_126,73179,526,6652,45389,52567
CAT_127,68545,526,6652,70053,77231
CAT_128,67867,522,6652,142122,149296
CAT_129,68905,522,6652,46625,53799
CAT_130,67486,522,6652,81274,88448
CAT_131,67519,522,6652,89194,96368
CAT_132,67840,522,6652,64393,71567
CAT_133,67519,526,6652,50621,57799
CAT_134,67423,522,6652,57529,64703
CAT_135,69009,526,6652,57541,64719
CAT_136,69390,526,6652,45157,52335
CAT_137,67591,526,6652,51037,58215
CAT_138,67567,526,6652,45357,52535
CAT_139,67021,526,6652,48621,55799
CAT_140,67857,522,6652,51929,59103
CAT_141,66412,526,6652,45405,52583
CAT_142,66538,522,6652,92338,99512
CAT_143,67321,526,6652,60053,67231
CAT_144,68444,522,6652,214578,221752
CAT_145,69327,522,6652,89514,96688
CAT_146,68466,526,6652,172710,179888
CAT_147,67195,526,6652,159726,166904
CAT_148,67230,526,6652,50821,57999
CAT_149,67300,526,6652,48269,55447
CAT_150,67428,522,6652,91434,98608
CAT_151,68103,526,6652,102070,109248
CAT_152,67224,522,6652,89538,96712
CAT_153,69065,522,6652,61993,69167
CAT_154,67827,522,6652,69009,76183
CAT_155,67779,526,6652,48421,55599
CAT_156,67057,522,6664,207498,214684
CAT_157,67679,522,6652,513954,521128
CAT_158,68419,522,6652,68393,75567
CAT_159,68703,522,6652,52065,59239
CAT_160,69014,522,6652,66137,73311
CAT_161,69464,522,6652,73874,81048
CAT_162,67988,522,6652,51713,58887
CAT_163,67521,526,6652,45621,52799
CAT_164,68516,526,6652,47541,54719
CAT_165,68116,522,6652,61913,69087
CAT_166,67897,526,6652,50117,57295
CAT_167,68482,526,6652,50853,58031
CAT_168,67988,522,6652,202146,209320
CAT_169,68537,526,6652,48821,55999
CAT_170,68984,526,6652,114910,122088
CAT_171,69570,526,6652,45021,52199
CAT_172,67988,522,6652,102186,109360
CAT_173,67573,526,6652,50613,57791
CAT_174,67234,522,6652,58921,66095
CAT_175,67929,522,6652,66065,73239
CAT_176,66825,522,6652,114530,121704
CAT_177,68889,526,6652,50189,57367
CAT_178,68063,526,6652,64277,71455
CAT_179,69224,526,6664,51213,58403
CAT_180,68910,522,6652,52049,59223
CAT_181,67476,522,6652,67881,75055
CAT_182,67558,526,6652,51309,58487
CAT_183,67558,526,6652,46789,53967
CAT_184,67847,522,6652,222010,229184
CAT_185,68003,526,6652,125574,132752
CAT_186,68477,522,6652,226282,233456
CAT_187,68778,522,6652,66137,73311
CAT_188,68731,526,6652,48485,55663
CAT_189,67353,522,6652,83082,90256
CAT_190,68170,526,6652,69949,77127
CAT_191,68002,526,6652,48333,55511
CAT_192,67939,526,6652,48493,55671
CAT_193,67136,526,6652,47933,55111
CAT_194,67082,522,6652,88530,95704
CAT_195,68406,522,6652,67641,74815
CAT_196,69450,522,6652,53945,61119
CAT_197,69304,526,6652,48805,55983
CAT_198,67488,526,6652,48845,56023
CAT_199,67125,526,6664,45061,52251
CAT_200,66824,522,6652,474339,481513
